identifier,Number of trading,Number of trading symbol,Number of buy,Number of sell,Trading frequency
1,3,1,2,1,55.39435185185186
2,17,7,13,4,3432.5366909722225
3,11,4,6,5,965.5198240740741
4,10,2,5,5,2689.7662962962963
5,8,5,5,3,2508.149027777778
7,2,1,1,1,47.352916666666665
8,55,4,52,3,615.0722812349687
10,551,9,275,276,26.832960684911896
11,38,11,21,17,385.0787399591149
12,58,9,40,18,470.21074047364675
13,27,6,22,5,1528.3162291666667
15,20,5,14,6,219.45301388888888
16,8,4,4,4,36.21208333333333
18,17,4,12,5,336.31275958994706
19,16,4,8,8,1079.7682291666667
20,51,19,28,23,104.37344714506172
21,186,24,109,77,390.5271527954739
23,35,12,19,16,199.077297979798
25,41,10,25,16,251.71890773809528
26,37,7,31,6,533.2230285493828
27,2,1,1,1,72.00069444444445
28,3,2,2,1,1596.0547222222222
29,66,3,51,15,213.69238916075872
30,297,13,152,145,49.70117084758259
31,14,5,11,3,1372.804423611111
33,82,12,43,39,1051.2426866830065
34,42,16,33,9,1622.828850925926
35,5,2,4,1,1589.5961805555555
36,1395,44,816,579,138.17232424487523
39,43,13,26,17,1006.542768904321
40,64,8,53,11,631.8711940448633
41,9,3,4,5,263.19319444444443
42,17,10,9,8,830.0856150793651
43,111,7,81,30,105.86765671847441
44,11,5,6,5,4238.942435185185
45,8,2,5,3,130.13063492063492
47,28,7,17,11,25.60040608465608
49,3,1,2,1,0.007222222222222223
50,2,1,1,1,0.27944444444444444
51,24,5,14,10,89.92549074074074
55,30,7,18,12,265.5182526455026
56,29,6,14,15,70.20758814102565
57,9,5,4,5,1536.2335416666667
58,59,2,55,4,319.39751594650204
60,1193,56,791,402,229.7714551032181
61,31,13,17,14,214.4636550925926
62,53,11,44,9,233.06935539021165
64,33,10,31,2,645.7783490299823
65,8,2,6,2,1668.5008796296297
66,22,4,16,6,845.8602980324074
68,127,7,124,3,386.0148619264131
69,8,3,4,4,265.9783101851852
70,13,6,7,6,643.3262083333333
71,45,25,31,14,375.3239303118909
73,12,3,7,5,687.3348703703704
74,8,2,5,3,3817.708449074074
75,76,19,66,10,1227.2507087620027
76,2,1,1,1,3995.4504166666666
78,26,7,21,5,765.9538086419752
81,34,9,17,17,61.33888323045268
82,19,7,11,8,943.364794973545
83,17,8,16,1,1864.7631770833336
85,72,9,62,10,645.2667145759084
86,153,18,80,73,210.16872322873508
87,572,28,352,220,131.93342231002202
88,56,23,36,20,1164.0993202160494
90,19,11,13,6,1857.2508333333335
91,17,9,10,7,973.8300810185186
92,4,3,2,2,3900.117777777778
93,25,5,15,10,492.10971296296304
94,229,21,118,111,63.252283846898806
95,72,16,44,28,518.4886145875729
96,48,14,25,23,536.8049641203703
97,51,13,31,20,596.9944108245151
98,4,2,2,2,271.87111111111113
100,404,22,248,156,153.8818537634064
101,19,4,13,6,440.73728645833336
102,2059,36,1764,295,153.09462811325406
103,100,14,78,22,1271.901623595066
107,25,1,12,13,85.50995555555555
108,3,2,2,1,23.43638888888889
109,2538,32,1652,886,70.22454550959355
110,380,25,190,190,136.55512925890804
111,20,7,10,10,561.8007473544974
112,13,8,9,4,957.902700617284
113,285,21,229,56,104.09479852927423
114,7,4,5,2,76.83611111111111
116,16,4,12,4,438.3185208333333
117,380,17,338,42,113.57727371557745
118,37,9,22,15,298.2900304646164
119,30,7,22,8,1071.5212288359787
120,160,14,80,80,149.39178659261694
121,3,1,2,1,2359.666574074074
122,20,5,14,6,78.185325
123,168,23,111,57,303.4171239124907
124,83,16,46,37,97.12825622294372
125,8,3,5,3,2356.9811689814815
126,216,22,147,69,96.3942571676089
127,14,4,7,7,354.9615451388889
129,126,10,93,33,342.24791683353897
130,139,16,84,55,16.08302947103854
131,18,6,14,4,1839.8774884259258
132,1017,12,727,290,46.8289988134356
133,26,10,15,11,268.19182870370366
134,134,29,80,54,169.65290182130556
135,43,12,19,24,435.455549452862
136,52,8,41,11,206.24397521219137
137,205,13,180,25,163.90540573048386
138,7,3,4,3,173.34199074074073
139,71,12,50,21,324.4983147496793
140,28,4,21,7,67.99451244212963
141,454,20,266,188,178.13702604873154
142,92,17,56,36,787.3441396917353
143,4,3,3,1,576.6172222222223
144,38,10,27,11,390.52373535353536
145,35,15,18,17,525.8651812678062
146,103,20,58,45,112.01145936447813
147,2492,40,1330,1162,237.2890186142662
148,134,13,70,64,63.81687442163099
149,28,9,27,1,1057.489802910053
150,32,6,16,16,9.178471119929453
152,7,5,6,1,54.62166666666667
153,27,7,17,10,1304.9883565656564
154,525,21,481,44,237.51961169356758
155,17,9,11,6,424.0989814814815
157,13,4,8,5,2513.805208333333
158,60,16,45,15,1596.8357050705467
160,3,2,2,1,1307.9998611111112
162,50,14,26,24,213.51135085978834
163,80,14,48,32,676.2927853030458
165,130,23,75,55,132.45235894083982
167,33,8,22,11,1324.1860256046864
168,97,9,92,5,627.5056641092616
169,20,11,12,8,521.432361111111
170,33,4,29,4,654.1625102212602
171,111,6,102,9,619.2497830364332
172,27,5,20,7,509.1589981481482
173,14,6,7,7,1032.927175925926
174,27,10,14,13,764.2306310185186
175,15,2,7,8,257.62659226190476
176,2,1,1,1,0.5397222222222222
177,64,14,52,12,1384.1791536136832
178,8,4,4,4,519.8410069444444
179,928,93,475,453,326.7899037679802
180,11,3,6,5,3136.298907407407
181,208,8,184,24,177.47593902181842
182,322,33,166,156,122.31454242694369
184,28,4,21,7,318.94873489858907
185,6,3,3,3,759.347175925926
186,61,20,30,31,213.36612362213404
187,66,14,28,38,345.8633621232163
188,237,35,129,108,95.02486252325716
189,633,42,326,307,164.41374408584844
190,38,6,24,14,278.4539152888007
191,40,8,37,3,759.8589459432762
192,5,3,4,1,2239.906388888889
193,17,7,9,8,393.14298611111116
194,44,5,36,8,336.16801157407406
195,309,18,227,82,100.3868051380154
196,21,9,11,10,876.1186111111112
197,174,17,128,46,124.32959993045792
198,79,22,76,3,1402.6139680399938
199,8,2,5,3,62.13583333333333
200,152,35,81,71,316.8888226629036
201,8,2,4,4,0.05990740740740741
202,20,4,14,6,407.04050925925924
203,14,3,8,6,323.82518518518515
204,7,3,4,3,1453.3073958333334
206,9,6,7,2,4334.471111111111
208,35,13,31,4,2761.2617340067336
209,46,10,27,19,354.7207259259259
210,9,3,6,3,538.9401388888889
211,918,47,468,450,169.46903431142155
213,12,5,6,6,160.6711388888889
214,337,17,258,79,223.0745805356415
215,19,4,9,10,115.89382733585859
216,142,16,110,32,196.8235330569315
217,17,4,12,5,459.0912913359789
218,27,10,16,11,71.78120576131688
219,23,7,15,8,1813.3787121212122
220,10,5,9,1,11.334247685185185
221,18,7,13,5,2946.2131666666664
223,5,2,3,2,555.9437962962963
224,14,9,13,1,2411.3922685185184
225,45,15,36,9,2562.6632308201056
226,43,20,22,21,1395.2518125000001
227,11,4,6,5,684.959699074074
228,137,25,72,65,37.69392365212693
229,39,5,20,19,490.02961728395064
230,13,4,7,6,711.4502976190475
232,14,3,8,6,258.07388756613756
233,31,7,16,15,208.18151455026455
234,10,4,5,5,103.10626736111111
235,873,37,504,369,120.28727239713803
236,10,4,5,5,900.477986111111
237,3,1,2,1,2248.657314814815
238,21,10,11,10,20.615300925925926
239,15,7,9,6,3937.122745370371
240,82,10,70,12,542.1137275460651
241,6,4,4,2,0.15222222222222223
242,38,12,17,21,485.0419501563251
244,16,3,5,11,93.91362654320987
245,4,2,3,1,3201.537592592593
247,60,14,32,28,276.8192748739864
248,19,8,10,9,744.8537301587302
249,130,7,67,63,88.48850101230968
250,4,2,2,2,12.719722222222222
251,43,10,26,17,301.3567063492063
252,53,13,26,27,292.40798958333335
254,102,13,51,51,24.38471546971547
257,16,2,11,5,22.198606701940037
258,304,11,160,144,154.9841252397153
259,13,2,11,2,23.42965277777778
261,29,5,16,13,512.9754736467237
262,10,4,6,4,2183.3726215277775
263,7,3,3,4,581.5283796296295
264,18,4,10,8,171.9387037037037
265,12,5,11,1,1223.9467162698413
266,7,4,4,3,1271.997314814815
267,3,2,2,1,1019.6468055555556
268,31,7,24,7,1160.500234882842
269,12,2,11,1,224.78913888888889
270,5,1,4,1,359.5710555555555
271,7,3,4,3,1023.0314930555555
272,4,2,2,2,12.259375
273,470,18,415,55,203.97191617748342
275,4,1,2,2,156.0065972222222
276,12,5,7,5,3968.9416666666657
278,13,2,9,4,559.0063573232324
280,79,14,40,39,145.8230172115142
281,146,7,87,59,113.1937097505669
282,56,9,32,24,23.3309384675681
283,24,6,10,14,132.93477222222225
284,4,3,3,1,1.0216666666666667
285,42,13,23,19,611.8200905717224
286,4,2,2,2,2387.3729166666662
287,18,9,15,3,2066.3996643518517
288,28,7,21,7,243.60616203703702
289,177,47,154,23,930.2088545888963
290,74,13,48,26,1015.2113693158435
292,84,9,69,15,256.3904643191171
294,16,9,13,3,1838.1738194444442
295,36,6,29,7,509.62191293183946
296,22,11,14,8,297.33715740740735
297,50,9,46,4,883.7889624485597
298,58,9,38,20,969.7977226898615
299,336,16,215,121,333.0592405386492
300,19,6,11,8,371.3248379629629
301,8,4,5,3,1387.3007098765431
302,30,4,16,14,160.83895454545453
303,5,2,3,2,108.30125
304,12,5,7,5,96.48498611111111
305,20,5,16,4,1248.9793152006173
306,240,25,172,68,238.38054940806288
307,37,11,21,16,349.60389599255336
308,8,2,4,4,9.125555555555556
309,31,7,22,9,140.890161976912
311,182,20,138,44,468.03152908234017
312,71,9,31,40,247.20272442680775
313,9,2,5,4,444.12107142857144
314,228,27,117,111,236.2218062864091
315,16,4,14,2,344.6201273148148
316,30,3,19,11,500.3020010288065
318,68,7,67,1,741.9874677579365
319,126,16,71,55,524.3637759445415
320,7,3,4,3,834.7867592592592
322,20,4,9,11,398.3247118055556
323,218,15,118,100,151.88969734836286
324,16,7,15,1,637.3304938271605
325,71,20,52,19,462.89979226190474
326,30,6,22,8,146.6921975308642
327,32,9,17,15,893.1371841931218
328,33,15,21,12,353.30737654320995
329,30,6,19,11,1395.3605640432102
331,4,2,3,1,847.4479629629631
332,20,3,9,11,577.8649444444445
333,23,7,13,10,812.0083042328042
334,148,11,84,64,256.6318352172519
335,3,2,2,1,935.9998611111112
336,19,7,10,9,167.14591071428572
338,5,1,4,1,1238.8160555555555
339,175,39,107,68,115.64350788717456
340,54,8,32,22,58.00764790764792
341,36,14,25,11,633.8361111111111
342,45,15,32,13,236.50336408730163
343,38,6,21,17,198.04379012345677
344,13,5,7,6,466.4879944444445
346,2,1,1,1,3624.4383333333335
347,50,13,27,23,10.178574862637364
348,11,4,7,4,440.9997916666667
349,2,1,1,1,480.0001388888889
350,13,3,7,6,172.5130158730159
352,55,15,25,30,108.88411078042328
353,6,2,3,3,1140.4417013888888
354,7,3,3,4,193.7714814814815
355,31,6,17,14,466.4292494658119
356,297,34,223,74,309.19927971679283
357,13,4,7,6,242.82958333333335
358,202,38,118,84,107.00614392320642
359,107,12,87,20,443.8674687265164
362,151,37,82,69,710.158946597783
363,102,13,57,45,135.2030019035405
364,13,7,8,5,1997.202296296296
365,85,13,48,37,26.707994587792378
366,246,17,130,116,137.79885534778606
367,18,8,11,7,1693.7656084656085
368,43,10,33,10,560.9313479166667
369,124,15,62,62,20.6189949845679
370,39,6,23,16,276.6063326318743
371,2,1,1,1,12.00013888888889
372,9,4,5,4,14.386261574074075
374,48,12,39,9,1516.1524771224147
376,5,3,3,2,2286.280138888889
377,22,6,12,10,246.99757716049385
378,132,9,85,47,581.6471668183297
379,113,8,60,53,226.8767986853039
380,2,1,1,1,2294.036527777778
381,14,5,12,2,132.77283333333332
382,12,3,9,3,438.05932561728395
383,36,8,18,18,112.77603699252136
384,14,4,7,7,624.6939525462964
385,69,13,36,33,213.30984472934475
387,34,6,28,6,458.14366005291004
388,543,35,264,279,178.81995257514913
390,29,4,27,2,454.11299575617284
391,45,11,22,23,131.34099116161616
392,41,10,38,3,868.0082481123236
393,419,30,249,170,54.62639071059487
394,4,2,2,2,0.40888888888888886
395,24,6,15,9,282.3558741181658
396,13,4,8,5,590.881066468254
398,52,10,28,24,146.16966714559388
399,23,8,15,8,611.9428327546295
400,263,20,132,131,308.97297128620966
401,3,2,2,1,516.3658333333333
402,339,28,173,166,78.64862941967428
403,6,3,3,3,222.6435648148148
404,11,5,7,4,864.8393981481482
405,110,9,68,42,402.85283889198564
406,47,3,24,23,92.81419973544973
407,101,29,61,40,321.57356801035047
408,325,38,184,141,298.7176549432226
409,304,30,154,150,41.120764346438115
410,2,1,1,1,636.0
411,350,29,172,178,268.791492544436
412,549,16,320,229,333.5278778280257
413,3,1,1,2,2935.9999074074076
414,487,22,280,207,222.32943028922458
416,43,11,22,21,155.26354306958473
418,138,17,70,68,76.8505495701851
419,42,11,23,19,332.8348390151515
420,364,20,277,87,227.57202867443715
422,219,30,198,21,370.6832396342311
423,18,6,9,9,100.93944444444445
424,13,4,10,3,984.3771481481481
425,81,16,36,45,85.74657836612654
426,32,4,28,4,928.7435416666667
427,338,26,170,168,68.9637941961742
428,22,8,11,11,119.07406770833333
429,17,8,9,8,192.91393849206347
431,4000,14,2271,1729,36.8468911426233
432,6,2,3,3,226.97277777777776
433,33,11,32,1,1437.4648063973063
434,83,12,69,14,613.8505956973839
435,21,6,19,2,177.74312037037035
436,69,20,36,33,118.71543939710388
437,88,22,47,41,250.3360193402277
438,22,7,12,10,688.338127362056
439,269,28,146,123,76.79690439987084
440,42,15,23,19,877.4629012345679
441,39,11,27,12,327.6256180188125
442,2,1,1,1,3431.766527777778
443,374,42,209,165,226.89220065699587
444,174,32,81,93,137.6499923146876
446,6,3,4,2,138.43891203703703
447,3,2,2,1,1043.4975
448,266,31,153,113,288.98184390685594
449,3,2,2,1,5039.852083333333
451,76,17,51,25,663.0594083800187
452,38,13,19,19,308.3198628917379
453,77,13,37,40,33.42205956424867
454,28,9,18,10,189.32858076131689
455,98,14,72,26,228.74448448916607
456,4,2,3,1,3096.0866666666666
457,14,5,9,5,1845.1163580246914
458,13,5,11,2,1224.1564660493827
459,278,14,160,118,191.34536476876514
460,12,5,7,5,1891.0466111111114
461,17,6,13,4,1247.4718055555556
462,155,17,77,78,550.121583644569
463,39,11,20,19,82.59669865319866
464,167,10,84,83,60.66948339895821
465,11,5,5,6,747.8486458333333
466,33,11,25,8,718.9243555555556
467,16,6,10,6,3434.727708333334
468,9,5,5,4,1059.0524305555555
469,9,4,6,3,1181.3815416666666
470,24,5,19,5,286.05335
471,37,8,31,6,613.1770234375
472,44,6,36,8,645.577806988536
473,14,4,10,4,831.141388888889
474,40,4,24,16,155.46117644862605
475,102,6,51,51,44.0034233079806
476,66,7,62,4,830.2153328322912
477,27,8,16,11,567.0921395502645
480,120,13,59,61,161.90601512703992
481,18,4,13,5,667.155619212963
482,47,6,42,5,877.1764264770724
483,11,4,6,5,506.4044861111111
485,6,4,4,2,252.65298611111112
486,7,3,4,3,1646.997986111111
487,332,72,166,166,94.62168123196248
489,6,2,4,2,64.31703703703704
490,18,6,11,7,15.561855709876541
491,3,2,2,1,227.79305555555555
492,13,6,7,6,339.2754722222222
493,326,31,158,168,143.96684247025607
494,10,1,6,4,796.7191666666666
495,8,3,5,3,879.4670833333333
496,152,17,123,29,181.94181545024506
498,34,8,17,17,97.61540476190476
500,262,16,184,78,203.87044552819864
501,13,4,6,7,247.2925659722222
503,19,8,10,9,291.2213095238095
504,30,8,18,12,465.612337962963
505,45,3,34,11,108.9679853128991
506,28,5,13,15,340.14250000000004
508,46,12,25,21,188.34581659397
509,34,9,19,15,238.24574382716048
510,27,8,20,7,2522.024476273148
511,2,1,1,1,2532.00625
512,51,12,31,20,788.9187499999998
515,23,9,12,11,44.524935699588475
516,2,1,1,1,2603.860416666667
517,413,45,214,199,121.84235337531511
518,13,2,10,3,1265.58203125
519,5,2,4,1,2413.2907638888887
520,18,6,7,11,407.8486774691358
521,8,3,4,4,236.00875
522,907,18,478,429,33.40283521989334
523,21,5,13,8,788.4852768518518
524,4,2,2,2,965.7473611111111
525,23,6,12,11,235.54659722222218
526,107,18,66,41,83.63839317558298
527,27,6,14,13,353.8995607363315
528,20,7,14,6,178.18418672839505
529,62,14,26,36,311.4350262266944
530,98,10,48,50,272.07694648175897
531,2,1,1,1,4859.999861111111
532,14,6,8,6,1264.3918055555555
533,12,4,6,6,1370.733420138889
534,19,5,17,2,451.14459259259263
536,33,9,13,20,421.0420197677837
537,6,4,4,2,174.5666666666667
538,263,14,257,6,648.5855461320976
540,8,2,3,5,557.8651620370371
541,56,11,41,15,44.735394901394905
542,22,3,11,11,445.0125154320988
544,140,11,120,20,298.7679170512105
545,10,7,8,2,128.52634259259258
547,40,7,20,20,332.4119107142857
548,26,10,13,13,191.06322546296298
550,11,3,6,5,32.87251543209876
551,74,19,45,29,75.11071183324472
553,1129,50,589,540,260.31885723556763
554,7,4,4,3,1767.2534259259257
555,27,7,17,10,709.488117063492
556,12,4,10,2,952.8857407407407
557,5,2,3,2,591.9080555555556
558,15,5,9,6,1278.6840055555554
559,3,2,2,1,840.5
560,8,3,4,4,3.6066550925925926
561,22,11,14,8,2708.9427983539094
562,206,8,186,20,136.89007415413232
565,175,10,95,80,420.4469548133545
566,42,14,25,17,385.92434523809527
567,41,12,19,22,174.40389660493827
568,10,4,6,4,730.9523148148149
569,3,2,2,1,4369.71125
570,10,3,8,2,119.78274691358024
572,41,12,17,24,556.4014530974426
573,19,12,17,2,1021.2806458333332
574,2,1,1,1,3541.5959722222224
575,5,2,3,2,608.2363425925926
576,195,26,110,85,194.4877243394398
577,15,10,12,3,199.73436342592592
578,18,4,9,9,102.25311973905724
579,166,26,119,47,191.17359427339636
580,40,6,28,12,915.2652400158996
581,50,12,26,24,514.4233445216049
583,17,8,9,8,211.70715277777776
584,19,8,10,9,268.7042158564815
585,3,1,2,1,64.0
586,8,2,7,1,1031.9859920634922
588,2,1,1,1,0.10319444444444445
589,76,20,42,34,2.9963523148148155
590,42,6,36,6,503.4236082267784
591,143,40,72,71,310.87500128417105
592,14,4,7,7,121.84114583333333
593,59,9,25,34,336.472011597456
594,5,2,3,2,27.999953703703703
595,17,6,10,7,197.57731018518515
596,15,3,7,8,1413.0264621913582
597,82,21,45,37,335.2185620590829
598,69,13,61,8,531.0213488310123
600,54,8,42,12,628.6265443948413
601,17,4,9,8,41.72676504629629
602,80,17,29,51,390.42294082633055
603,78,7,64,14,578.4923941965675
604,7,3,4,3,747.26875
605,11,2,8,3,145.15291666666667
606,38,17,26,12,931.4024001322751
607,40,3,31,9,700.9392215042582
608,18,11,16,2,246.0678587962963
609,10,7,9,1,1864.1591666666668
610,16,4,12,4,982.808201388889
611,16,4,13,3,1332.8070138888888
612,166,70,83,83,145.05080522486773
613,150,29,76,74,81.30262434644995
614,65,24,54,11,1468.9316162037037
616,36,11,22,14,856.445817271353
617,38,15,19,19,32.071466049382714
618,79,9,42,37,130.57802280743945
619,171,16,97,74,10.83115037183592
620,9,4,8,1,1005.885138888889
621,7,6,6,1,0.10777777777777778
622,91,26,57,34,558.8672835351376
623,16,6,9,7,1456.2827777777777
624,21,7,15,6,1261.8236468253967
626,287,50,170,117,817.4220941768817
627,17,8,9,8,148.2452876984127
628,3,2,2,1,156.20805555555555
629,2,1,1,1,1.1143055555555557
630,3,1,2,1,0.1948148148148148
631,21,4,19,2,670.6405762235449
632,18,5,7,11,841.0060194444446
633,63,20,33,30,461.8441640946502
634,23,15,18,5,1467.791216931217
636,10,3,6,4,158.7347839506173
637,23,8,12,11,127.37970734126985
638,40,7,22,18,479.38951955782306
639,4,2,2,2,4775.999930555556
640,5,3,4,1,0.616574074074074
641,4,2,3,1,2529.3596296296296
643,89,7,50,39,56.508928588236934
644,19,8,18,1,1157.3175115740742
645,8,4,4,4,144.23145833333334
646,34,5,27,7,267.75282916666663
647,1584,30,809,775,56.45111364710565
648,1216,72,633,583,114.07510981157073
651,194,36,110,84,399.3065400350624
652,30,5,16,14,194.07871296296295
653,13,7,7,6,1771.8574074074074
655,92,16,47,45,244.10990385627105
656,28,4,20,8,604.9413469328704
657,15,6,8,7,942.1594097222222
658,10,3,8,2,1434.628601851852
659,19,3,9,10,313.5897901234568
660,484,19,393,91,175.48273208156772
661,49,8,47,2,1119.524128863035
662,53,8,36,17,657.2433326903292
663,38,14,22,16,715.4016618441357
664,209,16,105,104,74.08612830578008
665,41,14,23,18,168.06352248677248
666,67,14,39,28,806.8192379104814
667,6,3,5,1,1734.5725
669,40,13,27,13,916.4560185185187
670,22,8,11,11,1349.0609027777778
671,32,6,20,12,646.6107050264551
672,9,3,4,5,721.223387345679
673,28,9,15,13,647.6580493827161
674,3,1,2,1,15.826574074074074
676,24,3,18,6,740.1443471035137
678,26,11,14,12,566.7684583333333
679,7,3,4,3,5.86054012345679
680,15,7,8,7,90.18667592592593
681,61,17,27,34,2.217244113457349
682,17,2,10,7,294.60272222222227
683,120,13,106,14,446.53612615162615
684,56,20,31,25,1020.5816452692188
685,526,26,382,144,44.14939748845761
687,49,5,26,23,124.21108395895897
688,10,2,8,2,1452.0
690,7,5,6,1,0.32037037037037036
691,4173,50,2096,2077,97.67092390100386
692,235,47,184,51,603.7220443590585
693,21,8,14,7,975.3624735449736
694,57,8,28,29,21.726774602644088
695,19,9,10,9,556.8901909722222
696,3,1,2,1,21.924351851851853
697,48,8,27,21,346.18708217592587
698,19,3,11,8,102.19017875514403
699,8,5,7,1,79.94210648148149
700,2,1,1,1,3959.172916666667
701,13,2,11,2,534.236162037037
702,1140,32,589,551,178.5660755250771
703,7,4,6,1,0.5672222222222222
704,148,34,75,73,63.89137595315903
706,5,2,3,2,2004.7870833333336
707,29,5,21,8,1668.3554402209227
708,5,2,3,2,1941.971111111111
709,4,3,3,1,4391.989722222223
710,100,26,51,49,506.6266383951697
712,29,3,26,3,607.6392194989107
713,4487,29,2638,1849,107.58354080764467
714,32,13,21,11,228.4779675925926
715,5,2,3,2,1713.5272453703703
716,22,9,14,8,337.3395277777778
717,1572,37,838,734,163.92146676273546
719,3,1,2,1,480.0733333333333
720,318,26,215,103,128.8274490419433
721,10,5,6,4,1291.624224537037
722,69,19,40,29,260.6572472787361
723,13,4,9,4,512.4166898148148
724,2,1,1,1,0.2658333333333333
725,87,8,64,23,373.6846970135382
727,40,18,20,20,306.8374169389979
728,69,16,51,18,797.9441832768408
729,262,26,149,113,336.5309373720905
731,3,2,2,1,3.16625
733,7,4,5,2,11.813425925925925
734,6,5,5,1,24.134305555555557
735,22,8,12,10,311.885126984127
737,16,6,15,1,1099.7007523148147
738,5,2,3,2,375.9999537037037
740,25,12,14,11,693.5370439814815
741,61,8,49,12,724.4377342971911
742,9,2,4,5,262.0373148148148
744,9,2,4,5,509.7403472222223
745,13,5,7,6,1155.1297777777777
747,39,12,20,19,230.45078914141416
748,35,7,18,17,7.522355709876543
749,23,6,12,11,706.3152527006172
750,33,6,19,14,76.7076388888889
751,262,6,127,135,75.24811497156787
752,116,27,64,52,393.5449560538207
753,258,19,158,100,263.2518046470609
754,7,3,5,2,361.4928125
755,14,12,12,2,1386.0380555555557
757,33,11,17,16,64.64923958333334
758,26,8,16,10,518.4889033564815
759,25,6,15,10,1238.0441288580248
760,14,3,11,3,730.4465354938271
761,31,9,17,14,708.1414284979423
762,2,1,1,1,480.0
764,2,1,1,1,324.66791666666666
765,52,7,27,25,580.8294706014884
766,8,4,6,2,1171.1999444444443
767,99,22,50,49,475.15107464799513
768,568,61,288,280,114.55597058684023
770,47,12,26,21,19.912788900913906
771,82,5,62,20,380.1498123221462
773,100,20,53,47,30.127345538720544
774,13,4,9,4,1012.2980787037036
775,10,3,9,1,334.1498148148148
776,131,25,73,58,154.55069125593542
777,18,6,9,9,522.0093055555557
778,39,9,22,17,567.1533919753086
779,10,4,7,3,1456.1271875000002
780,28,10,16,12,700.7942541152263
783,20,4,11,9,557.7946025132276
784,49,7,41,8,498.5297958095697
785,74,5,47,27,158.10515037720566
786,64,16,38,26,391.31496064814814
787,7,4,5,2,0.8521990740740741
788,1936,51,1398,538,62.90920758533086
789,29,10,16,13,132.45647890946503
790,1078,25,581,497,65.19932250622043
792,33,9,17,16,736.3959706790124
793,3,2,2,1,2437.2193055555554
794,458,71,371,87,261.7289893229923
795,12,4,7,5,1675.3636342592595
796,49,14,26,23,538.2173396672772
797,7,4,5,2,3224.983472222222
798,41,7,22,19,387.0294863315697
799,7568,94,4811,2757,54.58996544482368
800,66,16,35,31,288.34852471891537
801,34,13,17,17,680.0507268518519
802,15,8,10,5,1248.163925925926
803,3,2,2,1,12.00013888888889
804,1916,110,1058,858,170.78859872404712
806,6408,88,3254,3154,58.41580375710073
807,545,32,279,266,52.69991809032638
808,5,3,4,1,29.650069444444444
809,64,15,26,38,199.10510462962966
810,196,38,151,45,159.8442708036562
811,372,11,322,50,229.05247779532675
812,10,1,8,2,168.11108333333334
813,8,4,4,4,1309.6238194444445
814,19,7,17,2,230.7811408730159
815,11,3,6,5,634.2850231481482
816,23,6,17,6,758.6128611111111
817,27,9,13,14,332.1421412037037
818,17,8,10,7,367.6298677248677
819,1275,65,649,626,124.00159310122643
820,16,7,8,8,1195.6228670634919
821,122,14,112,10,263.4969521565361
822,32,9,19,13,1319.650462962963
823,50,18,25,25,174.483191872428
824,18,6,17,1,2027.0765879629635
825,12,4,8,4,646.4111875
826,15,6,11,4,1126.2458925925926
827,41,18,26,15,773.8774554843305
828,12,5,6,6,795.6478333333333
829,26,7,14,12,753.4758763227512
830,256,20,127,129,45.09177904541446
831,7,3,5,2,1824.123024691358
833,1159,47,592,567,128.5304878724342
834,16,4,11,5,382.2392845117845
835,37,16,34,3,1538.0222037037038
836,5,2,3,2,2509.2238888888887
838,219,36,113,106,174.0828444159612
839,183,8,172,11,128.73897108348268
840,59,11,33,26,246.73134974747475
841,3,2,2,1,2302.6019444444446
843,5,3,4,1,296.3948148148148
844,31,9,16,15,102.3630663580247
845,96,15,49,47,213.68799164113986
846,54,7,47,7,725.4861000881835
847,51,11,27,24,259.114290719697
848,9,4,7,2,860.2756481481482
849,287,36,144,143,83.7457917577791
850,32,16,29,3,225.08621422558926
851,251,27,137,114,76.59602488152171
852,34,16,23,11,2721.0161172839507
853,19,11,18,1,510.62684606481486
854,18,8,10,8,903.6636053240741
855,9,5,5,4,1254.0236458333334
856,22,4,12,10,941.3208449074074
857,21,7,11,10,1092.2455555555555
858,15,5,9,6,253.07345833333335
861,159,16,81,78,181.47741259020972
862,6,5,5,1,0.0725
863,20,5,10,10,69.29204861111111
864,8,3,5,3,2.3314814814814815
865,14,3,8,6,131.79937059082894
866,54,14,40,14,565.7182116402116
867,23,7,13,10,10.535099206349205
869,264,41,134,130,64.07545529753965
871,30,11,15,15,569.1672348484849
872,3,1,2,1,80.0
873,7,6,6,1,0.8601388888888889
874,88,28,54,34,974.9615081727134
875,10,4,5,5,90.03195601851851
876,97,5,79,18,317.78320184108725
877,2,1,1,1,0.08541666666666667
878,38,5,34,4,172.96541435878936
879,4,2,2,2,48.00833333333333
880,141,33,79,62,502.94048066311274
882,4,2,2,2,342.2500694444444
883,46,9,40,6,1028.3258971193416
884,28,11,18,10,1749.072127314815
885,24,11,14,10,722.9111706349206
886,47,8,25,22,706.193122131919
887,75,20,46,29,17.209903935185185
888,9,5,8,1,1046.0639969135802
889,6,1,3,3,932.0251851851853
890,319,29,243,76,168.5433524986211
891,24,6,18,6,615.9412345679012
892,16,6,8,8,530.3104555555556
893,12,5,6,6,893.9100833333332
894,51,14,26,25,278.5673757558579
895,33,11,20,13,1376.1672895622896
897,16,6,8,8,86.92779783950618
898,1980,44,1122,858,189.54485290580067
899,27,6,26,1,935.6248930555555
900,489,39,251,238,145.73520322747396
901,4,3,3,1,0.09152777777777778
902,49,14,26,23,309.866913040663
903,21,5,11,10,1101.4495271164021
904,2065,48,1227,838,117.67419650095344
905,3,2,2,1,72.20861111111111
907,3,1,2,1,1552.0484259259258
908,8,4,6,2,1411.8240625
910,34,16,31,3,474.06425578703704
911,17,6,9,8,813.387224537037
912,178,43,105,73,311.6599704636808
913,209,32,86,123,12.295631213115588
914,8,4,7,1,125.93441358024693
916,18,3,10,8,243.05546604938272
917,74,16,45,29,17.638146825396824
918,96,13,78,18,573.5050933090829
919,41,10,31,10,1692.897075
920,42,7,21,21,158.4098777399849
921,87,18,47,40,278.4993330761317
922,24,8,16,8,803.0766567460317
923,31,7,30,1,1466.4814641203702
924,154,34,76,78,105.72629940922447
925,62,14,51,11,979.2322122507122
926,16,5,8,8,1.469324074074074
927,1177,30,616,561,73.8606268572316
928,128,35,126,2,525.8182336104328
929,9,4,5,4,747.8379282407408
931,69,10,41,28,465.2753354276896
932,13,6,7,6,17.658912037037037
934,766,36,543,223,133.43068219067442
935,7,3,4,3,2016.126959876543
936,436,32,264,172,296.5956387758137
937,8,2,5,3,81.69800925925927
938,11,5,7,4,2873.9638194444447
939,553,38,306,247,201.57999390275253
940,3,2,2,1,3169.0645833333333
941,15,5,9,6,234.54007222222222
942,84,13,71,13,328.56962009055763
943,236,8,142,94,105.69761489313424
944,15,7,8,7,63.06743055555555
945,310,26,165,145,99.24360839973419
947,52,7,46,6,179.34929623617126
948,865,24,480,385,151.0928854942052
949,125,30,74,51,163.17578256172837
950,15,6,6,9,66.1866512345679
951,7,4,4,3,1416.3333796296295
953,21,5,20,1,1820.360159722222
954,6,4,5,1,2661.8633333333332
955,36,8,19,17,201.05173193993505
956,14,8,9,5,3662.7956712962964
957,23,5,12,11,165.2068402777778
958,643,30,369,274,101.47780876523254
960,12,6,11,1,905.259074074074
961,27,8,13,14,159.9789392361111
962,13,5,7,6,1585.061050925926
963,321,27,181,140,37.45818552747544
965,23,6,12,11,524.300412962963
967,74,22,39,35,236.78971461408963
968,9,8,8,1,0.009583333333333333
969,18,7,10,8,337.8983541666667
970,40,12,24,16,215.0156239478114
971,47,8,38,9,206.32347222222222
972,137,42,86,51,113.88060968660965
973,35,9,20,15,352.49047222222225
974,8,4,5,3,416.02043209876547
975,30,7,29,1,1000.2683373015875
977,173,14,122,51,273.90066572300873
978,17,9,14,3,165.8156365740741
979,20,9,12,8,578.6198048941799
980,56,8,30,26,34.42490157026615
981,84,8,70,14,648.1725062003968
982,2,1,1,1,3539.999861111111
984,52,18,28,24,20.35690329218107
985,44,18,26,18,71.67786543209876
986,65,14,37,28,171.93707792207798
987,18,4,9,9,534.0666163194444
988,20,8,12,8,1165.2219965277777
989,8553,50,6105,2448,34.693236766278126
990,52,13,31,21,272.56883936202684
991,80,13,57,23,68.0100606261023
992,2,1,1,1,2594.196111111111
993,6,3,4,2,1007.9255324074074
994,11,4,6,5,422.37067361111116
995,51,8,33,18,8.579393095330595
996,22,7,21,1,940.3537423280425
997,3,2,2,1,0.45
998,28,11,18,10,53.20666666666666
1000,27,2,14,13,565.1538407512627
1001,78,31,42,36,682.1086974715098
1002,33,7,21,12,187.59056721981725
1003,20,8,11,9,117.82050925925928
1004,5,2,3,2,238.5679166666667
1005,30,8,18,12,714.9879859788359
1006,23,12,12,11,215.007702020202
1008,4,3,3,1,0.06833333333333333
1009,45,15,26,19,191.4327447530864
1012,13,4,7,6,167.6576884920635
1013,15,6,10,5,488.7423611111111
1014,31,14,16,15,368.02902146464646
1015,110,15,64,46,131.39055185185185
1017,2,1,1,1,3287.9920833333335
1018,16,6,10,6,1616.9900611111111
1020,5,2,4,1,3240.1698148148143
1021,81,7,60,21,632.7741921768708
1022,7,3,4,3,2621.3035802469135
1023,36,28,32,4,1383.5655
1024,2346,88,1253,1093,77.16022355996847
1025,16,4,8,8,99.03665972222223
1026,116,15,108,8,255.92349931182352
1027,3,2,2,1,0.7656944444444445
1028,21,7,11,10,448.6207175925926
1029,60,14,57,3,496.31852781477784
1031,7,3,3,4,82.08177469135802
1032,9,5,5,4,758.8008680555555
1033,40,3,20,20,45.18351851851852
1034,96,18,52,44,160.98987755865534
1035,2,1,1,1,3302.7506944444444
1036,61,8,54,7,582.2694062378594
1037,6,3,3,3,56.566111111111105
1038,9,4,5,4,1876.6161458333333
1039,7,2,5,2,775.2826666666666
1040,7,3,4,3,75.4991049382716
1041,82,11,42,40,157.024999524087
1042,3,2,2,1,0.26611111111111113
1043,8,3,6,2,513.5468055555556
1044,3,2,2,1,2997.921388888889
1045,57,18,30,27,702.7490313180828
1046,82,15,41,41,70.56351111111113
1047,104,13,52,52,52.391552859177864
1048,2315,154,1171,1144,96.82900862819271
1050,31,6,19,12,530.2872583435084
1051,67,12,29,38,401.17241769547326
1052,34,10,17,17,133.38208912037038
1053,54,14,27,27,161.2773202754036
1054,3,2,2,1,2232.146111111111
1056,23,5,17,6,1301.0404940476192
1057,94,18,48,46,256.8133841122869
1058,21,5,11,10,187.68237824074077
1060,54,14,47,7,705.0217351444851
1061,20,7,11,9,301.4932330246914
1062,9,7,7,2,54.85409722222222
1063,9,4,7,2,102.03421296296295
1065,8,4,6,2,31.895246913580248
1066,4,2,3,1,24.764861111111113
1067,183,7,137,46,88.66981489457544
1068,14,6,8,6,1086.4670679012347
1070,26,6,14,12,434.86334215167545
1071,28,9,15,13,400.81244704861115
1073,34,7,21,13,140.7981216931217
1074,32,4,20,12,983.0290254103536
1075,130,6,100,30,166.20993257765625
1076,17,1,15,2,22.79300653594771
1077,42,10,27,15,364.3456352880659
1078,12,6,6,6,505.7326851851851
1079,14,4,7,7,65.33164930555557
1080,11,2,7,4,760.3290277777778
1081,11,4,6,5,319.2361265432099
1082,2,1,1,1,1452.5001388888888
1084,47,5,21,26,98.29205362589481
1085,52,5,26,26,86.92692948717949
1086,110,15,60,50,20.330897050244367
1087,3,2,2,1,0.97375
1089,183,16,93,90,73.59844794996806
1090,2,1,1,1,3564.0
1091,125,19,63,62,72.99119973544974
1092,30,6,15,15,181.1071199845679
1093,21,3,11,10,62.90400132275132
1094,71,14,40,31,213.24177330424206
1095,4,1,2,2,155.05083333333334
1096,50,15,27,23,439.29566220238104
1097,147,41,74,73,228.74001825504368
1098,30,9,16,14,239.25206404320988
1099,131,24,92,39,170.62661000172025
1101,19,6,12,7,709.0059845679012
1102,44,12,27,17,262.37409391534396
1103,378,30,204,174,232.19198190287167
1104,355,30,188,167,128.54995221946132
1106,14,8,9,5,91.04388888888889
1107,88,12,45,43,42.05283095142243
1108,112,24,64,48,273.6075176133024
1109,135,28,84,51,181.70583163480043
1111,15,6,11,4,1649.669875
1112,14,2,8,6,193.8913310185185
1113,11,6,10,1,98.49498611111112
1114,2,1,1,1,2494.8618055555557
1116,35,6,17,18,516.6988078703704
1117,20,6,10,10,188.15068287037033
1118,10,3,7,3,523.4064969135803
1119,27,6,22,5,609.0242264660493
1120,3,2,2,1,0.04625
1121,31,10,25,6,652.5593622448979
1122,26,8,14,12,70.71994357638889
1124,1026,59,561,465,78.1023928449844
1125,57,12,28,29,174.53764609638043
1127,4,3,3,1,1524.5
1128,119,28,66,53,23.577861997955747
1129,12,3,6,6,528.5143750000001
1130,76,13,39,37,36.98264969135803
1132,5,2,2,3,728.577662037037
1134,38,9,21,17,282.7609478982951
1135,5,3,3,2,1410.125486111111
1136,258,32,136,122,38.900106658086884
1137,10,3,6,4,382.5958827160494
1138,275,27,148,127,177.3596742229764
1139,45,7,25,20,73.99505448475686
1140,7,3,5,2,352.9058333333333
1142,9,4,5,4,1690.1603356481482
1143,78,22,55,23,1294.4696884920634
1145,44,5,23,21,78.25476728395061
1146,9,2,7,2,564.0807837301587
1147,16,2,9,7,462.5389902998236
1148,4,2,2,2,1307.9450000000002
1149,2,1,1,1,2904.000138888889
1150,18,7,9,9,101.80054563492062
1152,14,2,9,5,517.2083506944444
1153,41,16,24,17,435.30512152777777
1154,13,2,7,6,226.16291666666666
1155,57,18,31,26,288.78525549768517
1156,15,7,10,5,1367.666560185185
1157,28,8,27,1,305.4951547619048
1158,6,3,4,2,41.97245370370371
1159,6,2,4,2,117.05006944444443
1160,72,5,37,35,86.1924384920635
1161,15,5,8,7,129.97104166666668
1162,39,8,20,19,516.0626951058201
1163,86,18,49,37,81.4499763979666
1164,134,19,96,38,357.72531972063456
1165,18,6,10,8,498.50041512345683
1166,19,5,11,8,532.3779936507937
1167,46,2,24,22,138.88708101851853
1168,3,1,2,1,1047.7214814814815
1169,20,4,10,10,315.80350983796296
1170,12,7,8,4,2607.9206365740743
1171,48,10,46,2,1018.6465698412698
1172,4,2,3,1,0.07819444444444444
1173,10,5,6,4,972.7439166666667
1174,51,13,30,21,121.83164797008546
1175,7,5,5,2,485.8800694444444
1176,20,5,11,9,422.7408583333334
1177,122,17,63,59,218.5902100345189
1178,22,4,18,4,968.7669675925926
1179,7,2,4,3,799.8689814814815
1180,23,10,14,9,1044.4881741898148
1181,29,8,15,14,236.09152281746032
1182,34,13,21,13,250.81236289173788
1183,9,2,5,4,0.5387916666666667
1184,1935,63,1155,780,93.71655542029687
1185,29,4,15,14,224.29348134118968
1187,6,3,5,1,1206.0001851851853
1188,166,32,103,63,255.92653875434354
1189,5,2,3,2,1730.1666203703703
1190,15,5,9,6,181.80191111111114
1191,30,15,20,10,14.72800925925926
1192,14,5,8,6,32.630833333333335
1193,17,10,16,1,2098.8717534722223
1194,27,9,15,12,641.5555509259259
1196,636,46,339,297,62.94140707583723
1197,14,8,11,3,1002.2503472222223
1199,22,7,12,10,760.0092896825397
1200,25,12,15,10,15.53848263888889
1201,86,24,43,43,316.05738522376544
1202,6,4,4,2,179.02381944444443
1203,3,1,2,1,513.6805555555555
1204,12,4,7,5,655.5666111111111
1205,21,10,12,9,1534.9784310699588
1206,66,29,34,32,120.27755175264552
1208,6,2,3,3,1089.375
1209,800,47,402,398,38.52013554242175
1210,53,14,29,24,422.16528935185187
1211,22,1,11,11,159.24219696969698
1212,23,10,20,3,1281.9405478395063
1214,6,3,3,3,2316.50875
1215,24,8,12,12,77.95713541666667
1216,24,7,13,11,312.3083263888889
1217,14,7,7,7,248.82174603174604
1218,20,3,10,10,283.99541820987656
1219,21,5,13,8,473.8492374338624
1220,15,8,8,7,387.445119047619
1221,4,3,3,1,949.8711111111111
1222,91,18,47,44,260.5464467670533
1224,32,11,16,16,440.91240740740744
1225,1014,55,562,452,119.59748324784537
1226,28,7,18,10,103.31699971655327
1227,150,16,85,65,496.85148435697977
1228,270,22,147,123,191.5816431128414
1229,20,6,10,10,90.30919560185185
1230,74,17,41,33,73.94371373895201
1231,123,29,66,57,125.94577678260438
1232,61,17,31,30,100.95725115740741
1233,37,14,20,17,195.41171207264958
1234,22,6,12,10,144.8487638888889
1235,52,16,27,25,183.16311291152263
1236,592,50,404,188,30.460221892402195
1237,27,11,15,12,545.0410934343435
1238,18,6,9,9,98.40831790123457
1239,9,4,5,4,803.989710648148
1240,20,5,12,8,169.03285308641975
1241,139,33,76,63,265.1748088199397
1242,416,37,208,208,135.3919431380042
1243,1913,60,1071,842,97.05622961541177
1244,90,17,48,42,311.5082609221298
1245,24,8,13,11,84.88169270833333
1246,4,2,3,1,56.0
1247,5,3,4,1,207.37185185185186
1248,132,3,66,66,656.868211082176
1249,781,46,429,352,206.20466440833803
1250,82,11,78,4,533.3463150789048
1251,64,23,51,13,1066.4335211940836
1252,9,4,6,3,2579.670555555556
1254,825,55,449,376,45.228071864302194
1255,18,4,10,8,186.33957175925923
1256,13,3,7,6,582.7728395061728
1257,11,5,7,4,412.11634259259256
1258,3,2,2,1,0.09680555555555556
1259,4,2,2,2,82.96965277777778
1262,4,2,2,2,504.5
1263,10,5,6,4,1619.3665624999999
1264,4,1,2,2,510.5788888888889
1265,33,12,20,13,41.63062962962963
1266,11,5,7,4,128.12854166666668
1267,102,18,51,51,118.62963464506171
1268,10,4,7,3,42.290729166666665
1269,13,3,8,5,38.82345679012345
1270,11,3,6,5,69.36448412698412
1271,9,5,5,4,677.965
1272,22,3,11,11,64.41549857549857
1273,6,5,5,1,62.00791666666667
1274,137,31,70,67,195.67965023302233
1275,3,1,2,1,103.91037037037036
1276,16,7,8,8,484.85251984126984
1277,38,8,27,11,541.1387007747543
1278,3,1,2,1,392.41712962962964
1280,22,5,12,10,138.11858531746032
1282,8,4,4,4,356.755
1283,105,11,58,47,152.06399280685648
1284,7,3,4,3,5.51445987654321
1285,26,7,13,13,280.47204034391535
1286,868,40,444,424,69.32134679817874
1287,35,11,19,16,144.4472337962963
1289,95,14,49,46,117.290834814571
1290,20,8,11,9,767.0179332010582
1292,20,8,9,11,578.7081076388888
1293,39,11,22,17,66.49395594837262
1294,17,8,9,8,261.8591435185185
1295,29,9,26,3,328.7526286008231
1296,21,8,11,10,538.009525462963
1297,41,6,24,17,530.9285149176955
1298,13,5,7,6,490.3499016203704
1299,10,2,5,5,319.55135416666667
1300,29,3,15,14,559.9487681878308
1301,16,6,10,6,153.36737654320987
1302,31,6,22,9,47.090226733143396
1303,56,2,28,28,109.39432789855073
1304,10,8,9,1,42.45798611111111
1305,205,14,104,101,42.420215999785924
1306,211,21,105,106,37.19838045763807
1307,30,9,15,15,188.99425925925925
1309,13,4,7,6,310.2316087962963
1310,21,9,11,10,267.44824845679005
1311,69,22,35,34,131.10969549663298
1312,50,9,26,24,171.40055523921126
1313,7,3,4,3,213.67507716049386
1314,8,2,4,4,725.7932986111111
1316,4,2,2,2,720.2500694444444
1318,32,6,16,16,267.4025205761317
1320,14,5,8,6,500.05628472222224
1321,11,5,7,4,370.63324074074075
1323,324,28,154,170,91.81793212459725
1324,139,34,79,60,285.08360604430516
1325,17,4,9,8,301.8180648148148
1326,186,28,105,81,200.2883146233289
1327,30,8,18,12,117.1529581404321
1328,5,2,3,2,690.6790277777778
1329,1595,41,861,734,110.55329436800257
1330,19,7,11,8,758.511494047619
1331,44,20,23,21,989.8363148148148
1332,13,4,8,5,210.1799537037037
1333,264,38,132,132,46.20379195216941
1334,7,2,5,2,265.3529305555556
1335,19,6,12,7,80.25381172839506
1336,23,7,14,9,801.6805092592592
1337,23,6,12,11,809.8356007996634
1338,12,4,7,5,677.8335416666666
1339,10,4,6,4,79.85515625000001
1340,57,15,56,1,1259.3459299142216
1341,28,9,16,12,454.5088859953704
1343,49,15,43,6,680.9409231150794
1345,37,8,25,12,70.57875551146385
1346,104,3,89,15,75.50795706245461
1348,5,1,3,2,835.2609444444445
1349,81,16,39,42,266.4643781534219
1350,5,3,3,2,17.97479166666667
1351,7,3,5,2,672.8983641975309
1352,7,3,4,3,12.148348765432102
1353,54,5,29,25,312.26481527777776
1354,4,2,2,2,1169.2330555555554
1355,45,18,23,22,216.53704248366012
1356,13,4,7,6,84.58722222222221
1359,39,14,19,20,212.48247354497357
1360,24,10,13,11,296.53561111111105
1361,16,6,8,8,748.2864120370369
1362,18,8,9,9,424.79184193121694
1365,2,1,1,1,168.68972222222223
1366,418,16,211,207,45.53408865988357
1367,31,3,28,3,157.1769957912458
1368,131,21,69,62,165.64442074735229
1369,66,18,37,29,162.7577036792083
1370,4,2,3,1,0.7441666666666666
1371,133,11,86,47,153.97327374338622
1372,34,11,22,12,247.00433080808088
1373,22,5,12,10,319.5873944444445
1374,5,2,3,2,1051.29
1375,64,16,39,25,483.37261547619056
1376,25,5,19,6,50.517734932659934
1377,7,5,6,1,0.2288888888888889
1379,10,4,5,5,3044.562482638889
1380,11,7,7,4,693.3333333333334
1381,22,7,12,10,661.8194529478459
1382,13,5,7,6,1900.4445416666665
1383,84,17,59,25,563.5231166802037
1384,103,15,55,48,169.18111329356918
1385,3,2,2,1,0.6755555555555556
1386,145,15,73,72,25.59918956523909
1387,48,10,25,23,414.770187345679
1388,17,4,15,2,969.7735509259259
1389,5,3,3,2,1163.9999305555557
1390,3,2,2,1,34.750972222222224
1391,33,14,17,16,255.22662202380948
1392,9,2,5,4,134.63199404761906
1395,23,7,14,9,114.19148875661377
1396,7,3,4,3,2398.1609722222224
1398,354,23,184,170,222.5924301609973
1399,52,14,26,26,454.31186094576714
1400,7,4,4,3,2.4189814814814814
1401,35,11,18,17,155.19487542087543
1402,10,4,5,5,562.9292283950617
1403,2,1,1,1,1559.5002777777777
1404,37,7,19,18,88.9145101095994
1405,29,15,15,14,175.85901785714285
1406,40,10,25,15,302.25270826719577
1407,17,8,9,8,328.0937301587302
1408,691,57,351,340,160.5164577784727
1410,4,1,2,2,623.8019444444444
1411,370,17,183,187,351.6485285541178
1413,11,5,9,2,712.1249691358025
1414,6,5,5,1,3096.354861111111
1415,25,7,15,10,476.2312885802469
1416,57,13,45,12,422.3788938746439
1417,633,66,341,292,173.12735752697571
1418,18,6,9,9,5.893086419753086
1420,30,6,25,5,1119.178144973545
1421,22,8,16,6,0.23456790123456792
1422,6,4,4,2,576.4810416666667
1423,30,9,20,10,1750.1901491769547
1424,25,4,14,11,377.9844118265994
1425,30,13,17,13,534.7483501683502
1426,23,5,14,9,213.27016565656567
1427,84,13,61,23,376.7342760596291
1428,5,3,3,2,1158.2644444444445
1429,17,4,9,8,22.061787037037035
1431,2,1,1,1,0.4861111111111111
1432,35,4,32,3,593.4320758101852
1433,68,11,32,36,87.97710682482722
1434,23,9,14,9,496.0991018518518
1437,31,9,20,11,122.00797692533804
1438,3,1,2,1,312.33324074074073
1439,8,4,5,3,639.4381944444444
1440,37,13,19,18,565.2046431327161
1441,7,3,4,3,1649.4745486111112
1443,78,10,44,34,85.80366876780627
1444,16,6,12,4,450.0142386831276
1445,559,19,368,191,26.75845580517867
1447,55,16,28,27,374.0276982060185
1448,5,3,3,2,1.0924305555555556
1449,220,15,180,40,59.23811065759949
1450,5,3,3,2,1260.099861111111
1451,21,4,13,8,209.65233134920632
1452,14,4,7,7,147.48259837962962
1453,12,4,7,5,61.0495787037037
1454,17,4,10,7,100.49477366255144
1455,9,5,5,4,458.8913541666667
1457,6,3,5,1,0.03763888888888889
1458,10,2,5,5,64.86458333333334
1459,1778,121,1373,405,80.20127161631106
1460,6,3,3,3,1.7794907407407408
1461,22,7,11,11,340.1500892857143
1462,15,6,8,7,398.14195601851844
1463,21,7,12,9,27.24431216931217
1464,23,6,13,10,230.2143529541446
1465,12,8,8,4,999.4744097222223
1466,87,30,44,43,20.621534319645733
1467,39,8,27,12,486.3630926477073
1469,33,15,20,13,368.42741126543206
1470,7,6,6,1,3455.7966666666666
1471,14,7,7,7,630.7493055555555
1472,28,13,14,14,121.84721688034188
1474,757,50,416,341,86.96416362351434
1475,27,9,14,13,62.21588734567902
1476,22,4,12,10,330.5554700854701
1477,17,9,9,8,108.52892361111111
1478,18,3,11,7,1083.1591632996633
1479,74,16,39,35,1533.4924746472661
1480,63,7,46,17,112.97707315832315
1481,90,25,74,16,511.0615265988037
1483,4,2,3,1,2135.999444444444
1484,4,2,2,2,534.7626388888889
1485,44,5,28,16,107.61742868165784
1486,2,1,1,1,577.1665277777778
1487,4,2,2,2,168.33263888888888
1488,15,5,8,7,8.755722222222222
1489,5,4,4,1,2569.7819444444444
1491,29,5,16,13,413.5178367965368
1493,6,3,4,2,109.90409722222222
1494,24,9,12,12,596.5823302469137
1495,99,20,51,48,127.3820111882716
1496,162,18,82,80,208.80088564079955
1497,10,3,5,5,1253.2885462962963
1498,30,7,20,10,727.47848324515
1499,19,3,9,10,442.57123809523813
1500,23,7,12,11,602.2840575396825
1502,49,14,33,16,832.9254708994711
1503,13,3,7,6,301.0687037037037
1504,550,33,322,228,238.9056699222992
1505,17,7,9,8,2.326853174603175
1506,497,23,255,242,96.18368540044966
1507,26,6,13,13,288.49518867577893
1508,28,8,20,8,675.9895153356481
1509,15,6,8,7,283.1836388888888
1510,78,23,39,39,856.9280889694043
1511,4,2,2,2,870.5977777777779
1512,60,14,31,29,159.6454899691358
1513,34,12,17,17,364.42295910493834
1514,16,7,8,8,1534.0234325396825
1515,47,5,25,22,70.78826792929291
1516,39,12,21,18,375.90136153198654
1517,2052,47,1121,931,101.63745701357743
1519,129,1,65,64,34.58753014642549
1520,21,5,10,11,556.9205534391534
1521,79,24,41,38,147.6426362893151
1522,24,10,12,12,64.38490277777778
1523,29,12,17,12,2517.32152970679
1524,66,9,56,10,535.0062836700337
1525,32,6,16,16,449.5819391534392
1526,34,9,18,16,302.94025077160495
1527,70,16,43,27,152.03859470072751
1528,9,4,5,4,576.9995601851851
1529,17,8,11,6,596.8718121693121
1530,45,17,23,22,336.94951906318084
1531,135,20,86,49,85.29915118928187
1533,47,10,37,10,411.5953134700177
1535,13,5,7,6,276.26456018518513
1536,15,6,9,6,51.07226851851851
1537,5,2,3,2,466.4928703703704
1538,7,4,4,3,436.05601851851856
1540,10,5,7,3,400.3250925925926
1541,25,8,15,10,92.02687786596118
1542,15,6,9,6,763.2668564814816
1543,377,35,199,178,15.045280407983702
1544,7,4,6,1,0.14152777777777778
1545,22,2,13,9,310.276454248366
1546,73,17,35,38,58.62100976501712
1547,19,8,10,9,502.9077526455026
1549,403,38,336,67,184.2040109063287
1550,11,4,7,4,294.440005787037
1551,6,3,4,2,6.228125
1552,5,2,3,2,4.558819444444444
1553,11,4,6,5,73.29524999999998
1554,111,20,79,32,281.19254435769886
1555,759,35,379,380,144.39644269779865
1556,6,3,3,3,443.32865740740743
1557,508,62,279,229,155.0461844471229
1558,129,19,72,57,129.65615667641327
1559,29,8,15,14,136.33707031249997
1560,5,3,4,1,6.499513888888889
1561,5,3,3,2,348.9189583333333
1562,414,23,309,105,112.9758436599358
1563,15,4,14,1,423.51371913580243
1564,12,4,8,4,996.3333333333333
1565,10,5,5,5,583.2078888888889
1566,40,12,21,19,74.33763657407407
1567,77,13,39,38,262.8690474260733
1568,6,3,3,3,3.992129629629629
1569,34,10,19,15,420.0497420634921
1570,6,3,3,3,240.81949074074075
1571,46,12,26,20,284.68477595899475
1572,26,6,22,4,663.763293595679
1573,477,46,287,190,213.02466396212694
1574,37,8,19,18,248.1405447048611
1576,18,7,9,9,615.8970734126984
1577,70,22,41,29,474.2239213659148
1579,13,3,9,4,50.95130401234568
1580,3,1,2,1,136.3925
1581,17,3,9,8,48.76664517195767
1582,36,13,19,17,194.33787731481482
1583,17,6,11,6,237.00403086419752
1584,115,12,81,34,201.90754346750796
1587,135,22,78,57,164.74471916039911
1588,3,1,2,1,288.0001851851852
1589,364,23,234,130,238.6326301532408
1590,17,5,11,6,173.295703125
1591,34,12,19,15,461.59976576278655
1592,18,9,10,8,542.6563591269841
1593,38,6,27,11,320.27340292207793
1594,37,14,20,17,100.35147652116406
1595,84,20,40,44,344.16963460735167
1596,7,2,4,3,233.96705555555553
1597,48,7,25,23,142.0363900560224
1598,12,4,7,5,188.52003009259258
1599,10,2,6,4,172.957585978836
1600,19,9,10,9,174.14394097222225
1601,9,3,5,4,567.5741203703705
1602,4,2,3,1,128.1064814814815
1604,9,6,8,1,258.90085648148147
1605,165,13,89,76,218.10097719588106
1606,4,2,3,1,56.333333333333336
1607,821,32,459,362,88.76977050776938
1608,32,9,17,15,1621.8660288065844
1609,7,5,5,2,497.015
1610,2,1,1,1,2603.5
1611,23,5,14,9,669.9237777777778
1612,399,29,200,199,166.202323628623
1613,9,2,8,1,521.2173680555555
1614,25,6,14,11,562.7624074074075
1616,27,5,16,11,120.0722762345679
1617,12,4,9,3,631.3945416666667
1618,10,3,5,5,712.1665046296297
1619,278,27,169,109,159.30323083925583
1621,104,11,78,26,226.54147967007373
1622,103,12,51,52,215.13927546660753
1623,21,7,11,10,139.3613558201058
1624,218,10,168,50,135.8323676712293
1625,5,3,3,2,455.5340972222222
1626,337,27,176,161,90.621497743385
1627,33,5,18,15,460.65493194444446
1628,78,16,46,32,36.62783337304829
1629,2277,90,1429,848,58.79595164218581
1630,29,5,27,2,362.1807582010582
1631,5,2,3,2,349.9999305555556
1632,11,5,7,4,2012.3421990740742
1633,12,8,8,4,1427.7726388888889
1634,37,6,31,6,738.0915013227514
1635,6,4,4,2,503.285625
1636,32,4,19,13,298.68608134920635
1637,3,1,2,1,471.9999074074074
1638,10,4,5,5,627.2658333333334
1640,53,6,38,15,140.81559128654268
1641,72,19,36,36,120.30501157407406
1642,22,4,14,8,197.5061857638889
1644,4,2,2,2,731.3375694444444
1646,1387,46,727,660,45.319150737931885
1647,332,15,240,92,101.04669598991863
1648,635,36,402,233,68.60125124471564
1649,35,18,18,17,187.63608660130717
1651,53,6,51,2,303.3994666907167
1652,8,2,4,4,563.9463425925926
1653,3,2,2,1,1857.9145833333334
1654,26,5,13,13,8.040449074074072
1655,36,7,22,14,510.3962370664315
1656,363,10,358,5,119.09688072889575
1657,38,4,19,19,100.41624537037038
1658,209,47,104,105,101.6081286164584
1659,28,7,16,12,441.1683050144301
1661,9,4,5,4,219.5129050925926
1662,2,1,1,1,0.47194444444444444
1663,41,5,37,4,324.0726925925926
1664,2,1,1,1,1990.8240277777777
1665,94,12,48,46,168.99132980324075
1666,6,2,4,2,297.14208333333335
1667,9,5,5,4,193.86743055555556
1668,6,3,5,1,0.011898148148148147
1669,8,5,5,3,968.2901851851852
1670,19,4,15,4,964.334746031746
1671,40,13,33,7,1074.8799946581194
1672,19,3,10,9,326.7777866809117
1673,62,17,34,28,221.14310838779957
1674,13,5,7,6,306.9327314814815
1675,17,8,9,8,375.25129050925926
1677,20,10,10,10,81.84963888888889
1679,14,7,8,6,538.5803163580248
1680,146,26,92,54,268.5107567102072
1681,11,4,7,4,60.50577546296295
1682,4,1,3,1,203.74645833333332
1683,37,13,21,16,284.81779031635807
1685,20,8,11,9,0.42391534391534386
1686,67,11,51,16,308.4991265284423
1687,19,6,10,9,426.081362654321
1688,10,5,9,1,1053.3419598765431
1689,36,14,18,18,146.23183283730157
1690,19,5,11,8,166.61436805555556
1691,5,4,4,1,0.31819444444444445
1692,120,10,61,59,87.58716843820862
1693,48,14,24,24,359.2812433862433
1694,16,7,9,7,179.05209656084656
1695,7,2,5,2,52.09292824074075
1696,75,10,41,34,188.17120494257088
1697,7,3,4,3,114.0529012345679
1698,25,9,13,12,364.76821469907406
1699,33,8,25,8,912.8401168981482
1700,7,3,4,3,244.6523611111111
1701,38,13,24,14,769.452707977208
1702,69,18,38,31,127.19873823302467
1703,13,4,6,7,837.3987962962963
1704,7,3,4,3,221.40529320987653
1705,35,14,18,17,419.37004706790134
1706,72,10,39,33,74.45355330330331
1707,18,8,10,8,88.68026909722224
1708,2,1,1,1,0.4597222222222222
1709,6,1,3,3,31.836805555555557
1710,185,33,99,86,335.43398822868875
1711,22,13,19,3,1474.0338333333334
1712,113,33,57,56,267.62535300925924
1713,13,8,8,5,1506.048388888889
1714,59,13,33,26,187.26992712148964
1715,10,4,5,5,129.5748611111111
1716,36,12,20,16,261.0262055555555
1717,85,27,50,35,281.50513709646503
1718,15,7,8,7,917.7078703703704
1719,35,15,19,16,318.9547654320988
1720,111,14,65,46,152.73562681426318
1721,16,5,10,6,60.026905092592585
1723,218,14,113,105,57.09118169231716
1724,82,8,50,32,385.03752731769026
1725,35,5,21,14,211.57087459150324
1726,6,2,4,2,203.73565972222224
1728,2,1,1,1,610.9020833333333
1729,19,7,11,8,216.75295524691356
1730,177,26,97,80,247.49830067997735
1731,2,1,1,1,23.9775
1732,65,7,37,28,22.68991395757021
1735,4,3,3,1,2098.946111111111
1736,199,36,102,97,112.82345032596373
1737,2,1,1,1,1044.088611111111
1739,59,15,30,29,6.383912345679011
1740,58,14,36,22,485.9634136002886
1741,549,46,398,151,246.58035482466664
1742,109,14,55,54,69.52785552248677
1743,788,28,397,391,89.3920105774758
1744,819,49,456,363,118.60435416974303
1745,5,3,3,2,982.132638888889
1746,245,14,172,73,255.64231459750548
1747,13,2,7,6,258.44831790123453
1748,4,3,3,1,0.3036111111111111
1750,24,6,12,12,185.35029706790127
1751,59,23,29,30,586.5629166666666
1752,65,9,55,10,213.68286005780914
1753,20,7,11,9,707.2030158730158
1754,17,5,11,6,677.0329930555556
1756,9,3,5,4,406.64465277777776
1757,7,4,6,1,264.33875
1759,59,15,30,29,176.98537748015875
1760,1489,67,902,587,58.503037259281705
1761,16,6,9,7,590.8227577160493
1762,84,24,45,39,181.81667292664395
1763,41,9,21,20,152.71682014590345
1764,12,6,7,5,862.2466666666667
1765,2,1,1,1,935.1452777777778
1766,203,43,118,85,58.25775461056953
1767,62,7,44,18,147.54105287226
1768,7,4,4,3,619.9575462962963
1769,19,5,11,8,160.16794907407407
1770,127,11,91,36,280.5188440639918
1771,107,31,56,51,332.6757537568465
1772,984,54,483,501,80.85064140725918
1774,26,4,21,5,618.5439566798942
1776,84,19,42,42,85.16277521929824
1777,7,3,4,3,369.0417013888889
1778,3,2,2,1,37.99069444444444
1779,898,48,453,445,77.99006387853312
1780,119,20,62,57,41.401473528439155
1781,10,2,9,1,384.08635582010584
1782,3,2,2,1,0.1723611111111111
1783,33,14,17,16,343.61712136243386
1785,13,1,11,2,273.15384615384613
1787,10797,119,6698,4099,42.64295191078149
1788,29,10,22,7,666.7297352430555
1790,27,6,21,6,618.4531665564374
1791,21,4,13,8,11.608449459876542
1792,1977,57,1094,883,123.17954688941032
1793,85,24,45,40,59.287956757973255
1794,5,2,3,2,1200.6762037037038
1795,46,10,23,23,537.4305380658435
1796,31,9,17,14,125.61181400646677
1797,20,9,11,9,999.2272479423868
1798,511,35,262,249,65.59610113586547
1799,35,6,30,5,359.3346573706644
1800,34,10,19,15,261.23564715608467
1802,22,7,12,10,287.2526891534392
1804,219,48,117,102,242.3984374047859
1805,4,2,2,2,0.92125
1806,86,10,72,14,143.99883668300654
1808,39,9,20,19,397.8635401234568
1809,2,1,1,1,0.02486111111111111
1810,15,7,8,7,6.33375
1811,26,13,14,12,161.8262114197531
1812,56,13,31,25,272.26717447598696
1813,77,4,39,38,21.777061683006536
1814,46,4,20,26,109.96150396825396
1815,6,2,3,3,0.05659722222222222
1816,451,24,239,212,75.60894765424992
1817,10,1,6,4,12.225194444444444
1818,105,21,53,52,117.58864439603002
1819,106,21,54,52,85.02255006105005
1820,74,21,39,35,435.9267445987654
1821,71,14,65,6,729.7478239087303
1822,54,19,32,22,213.9604989858907
1823,1581,40,768,813,67.79446917243533
1824,31,11,16,15,384.0555618686869
1826,200,43,100,100,300.346499461671
1828,711,46,375,336,72.17247201001607
1829,171,24,88,83,42.834533800690046
1830,55,13,28,27,115.73141234228736
1831,4,1,2,2,0.3821527777777778
1832,39,12,20,19,34.7883132164903
1833,160,27,98,62,271.6059539141414
1834,4,2,2,2,401.89743055555556
1835,123,29,66,57,122.01203095586033
1837,27,12,16,11,631.559
1839,12,8,10,2,1572.2054629629629
1840,161,18,102,59,69.33565127278983
1841,22,4,13,9,505.5450677910053
1843,42,11,22,20,101.47233579383578
1844,44,3,24,20,121.30170601851852
1845,34,11,24,10,299.4300831228956
1846,68,19,35,33,176.59279189292675
1847,104,25,96,8,769.8653161926808
1848,201,19,141,60,112.42801041925098
1849,130,20,73,57,238.33606181607743
1850,45,13,28,17,277.7055975783476
1851,38,7,20,18,339.9813062169313
1852,391,50,207,184,71.76935066418149
1853,53,10,29,24,67.32862172873423
1854,158,20,81,77,10.832270185880065
1855,245,47,123,122,98.84547323539344
1856,35,7,18,17,6.451482426303855
1857,211,24,138,73,247.47238042780268
1858,10,5,5,5,700.4436944444444
1859,355,14,189,166,79.6650999703122
1860,8,4,4,4,1943.622986111111
1861,25,5,18,7,86.59658055555555
1862,61,10,35,26,207.17024824074073
1863,5,3,3,2,1073.2925
1864,15,8,10,5,746.0007777777779
1865,35,9,16,19,412.3298189300411
1866,173,24,91,82,77.92193472325214
1867,31,17,18,13,1042.7308217592595
1868,9,4,6,3,228.59641203703703
1869,57,13,29,28,98.64274553571427
1870,15,7,11,4,105.41832407407408
1871,5,3,3,2,137.9584722222222
1872,14,4,9,5,256.5719560185185
1873,28,14,16,12,243.1513078703704
1874,40,7,32,8,234.0280080467372
1875,324,31,194,130,60.56163238105165
1876,14,5,8,6,19.19828703703704
1877,24,9,14,10,254.56757465277778
1878,18,7,10,8,315.65049603174606
1880,23,4,12,11,356.745174382716
1881,15,3,9,6,581.6916552028218
1882,70,11,36,34,158.3220640844722
1883,35,9,24,11,341.64402006172844
1884,18,6,9,9,86.72016782407407
1885,133,30,66,67,142.07065817901233
1886,4,1,2,2,29.16576388888889
1887,34,10,21,13,32.936342592592595
1888,11,6,6,5,741.2940000000001
1890,15,5,8,7,224.253175
1891,48,11,26,22,17.084042508417507
1892,26,6,19,7,359.1172389403293
1893,13,4,10,3,1344.7288252314813
1894,36,14,23,13,431.72732549857545
1895,10,5,6,4,276.4598958333333
1896,415,20,210,205,42.297370809973934
1897,173,34,88,85,98.64764256535949
1898,4,2,2,2,0.39152777777777775
1899,39,15,22,17,162.9333222934473
1900,5,3,4,1,0.08444444444444445
1901,21,5,13,8,117.51099247685185
1902,13,5,8,5,398.3623518518518
1904,3,1,2,1,288.0000925925926
1906,9,6,7,2,568.0000462962963
1907,3,2,2,1,348.145
1908,11,4,6,5,488.9308333333333
1909,204,21,112,92,88.8084791971124
1910,10,6,6,4,3.1024652777777777
1911,1531,15,1098,433,28.178112557459613
1912,4,2,3,1,0.08368055555555555
1913,230,20,117,113,19.91391703852677
1914,55,5,47,8,178.69021615791615
1915,14,5,7,7,108.46243055555556
1916,4,2,2,2,335.42409722222226
1917,24,8,12,12,202.5899016203704
1918,16,10,15,1,1730.2441898148147
1919,72,8,36,36,65.8607254050926
1920,31,13,17,14,203.4396990740741
1921,20,5,10,10,216.41457175925927
1922,41,15,26,15,403.99318132716047
1923,17,7,9,8,279.761455026455
1924,37,7,22,15,22.958480004122862
1925,8,3,6,2,1267.9865740740743
1926,19,8,11,8,6.841064814814816
1927,42,6,23,19,10.568007716049383
1928,40,7,22,18,361.6382837301588
1929,21,10,11,10,198.5678935185185
1931,46,6,23,23,87.04885931069958
1933,14,5,12,2,362.923113425926
1934,44,7,26,18,167.576000518726
1935,161,34,83,78,40.20160169623404
1936,457,23,238,219,77.50303583900799
1937,15,6,8,7,78.74826851851851
1938,74,16,42,32,126.0638291005291
1939,136,20,84,52,76.15038215732356
1941,170,9,92,78,9.268173847221188
1942,10,4,5,5,54.505781250000005
1943,48,33,39,9,509.65
1945,7,1,6,1,575.8572222222222
1947,9,5,6,3,1772.2185030864196
1948,5,3,4,1,857.9915277777778
1949,8,4,5,3,492.7236574074074
1951,288,13,149,139,13.237011930199431
1952,566,106,313,253,102.75867946902056
1953,3,2,2,1,48.524861111111115
1954,271,34,139,132,165.44943880506744
1955,14,6,7,7,89.02895833333334
1956,83,14,43,40,184.1285867346939
1957,23,7,12,11,285.1833290816327
1958,45,9,23,22,134.5775217013889
1959,25,9,12,13,156.77236882716048
1960,23,9,12,11,522.1586371527777
1962,4,1,2,2,575.6617361111112
1963,33,11,18,15,133.47245959595963
1964,6,3,3,3,776.9278240740741
1966,4,2,2,2,829.1899305555555
1967,8,4,5,3,1355.6667592592594
1968,18,7,10,8,99.09961970899471
1969,11,9,10,1,1620.3714583333333
1970,9,3,5,4,456.9095216049382
1971,4,2,2,2,107.890625
1972,12,8,8,4,118.1132638888889
1973,11,4,10,1,693.2163456790122
1974,25,2,13,12,140.86117063492065
1975,7,3,3,4,96.13354938271605
1976,16,6,10,6,133.63896296296295
1977,33,15,17,16,37.05186507936508
1978,5,3,3,2,1226.727361111111
1979,9,5,5,4,357.90954861111106
1980,8,4,4,4,15.369305555555556
1981,64,14,35,29,280.6368484268707
1982,23,12,12,11,110.02175505050505
1983,17,6,9,8,231.62241666666668
1986,48,13,24,24,149.99322204415955
1987,6,3,3,3,124.24398148148147
1988,38,13,23,15,206.1586296296297
1989,11,3,6,5,244.62386904761902
1990,8,5,6,2,331.80155092592594
1991,28,4,15,13,214.8570702160494
1992,12,4,7,5,204.85035185185183
1994,15,5,9,6,309.65225694444445
1995,187,18,94,93,90.82887402065526
1996,10,2,6,4,389.68026041666667
1997,1206,35,798,408,90.68691584019228
1998,23,8,13,10,52.15187996031746
2000,11,3,6,5,123.61063492063492
2002,1444,39,764,680,82.43633657682518
2003,6,3,3,3,189.94050925925924
2004,9,5,6,3,471.3671180555555
2005,14,7,8,6,19.91482142857143
2006,161,15,80,81,112.72068677818352
2007,3,2,2,1,251.9998611111111
2008,79,12,40,39,272.9084909611993
2009,471,28,239,232,24.440934508493346
2010,10,3,6,4,27.851438492063494
2011,14,5,7,7,37.16894444444445
2012,53,10,39,14,77.11811885090218
2013,36,9,19,17,20.6177090815563
2014,39,9,23,16,147.38730709876546
2015,44,9,23,21,78.41997755331087
2016,18,8,16,2,235.62019179894187
2017,26,10,15,11,420.69030489417986
2018,16,5,8,8,67.05451388888889
2019,30,11,17,13,302.9583121141975
2020,3,2,2,1,275.9998611111111
2021,45,18,24,21,149.0911754115226
2022,59,15,42,17,396.4156111111111
2023,127,29,66,61,42.88083722176611
2024,52,6,44,8,192.05227573005698
2025,40,6,21,19,139.83961627243488
2026,8,5,6,2,1244.1929629629628
2027,2,1,1,1,1523.4998611111112
2028,183,26,97,86,153.03733092572605
2030,9,2,5,4,85.17169642857144
2031,236,22,141,95,62.803947972574186
2032,4,2,3,1,686.6441666666666
2034,58,10,34,24,131.66264459876544
2035,54,12,33,21,153.54397000385802
2036,10,4,6,4,0.17310185185185187
2038,10,4,6,4,480.5450000000001
2039,90,13,47,43,134.2514584350834
2041,18,7,10,8,369.63994444444444
2043,156,47,80,76,80.48072215655371
2044,41,10,24,17,141.93237927350424
2046,20,9,10,10,26.214915123456795
2048,3,1,2,1,38.95138888888889
2049,12,5,8,4,280.0348055555556
2050,17,8,9,8,96.19402777777779
2051,45,8,24,21,160.06819282407406
2052,29,7,18,11,65.15243570483749
2053,12,5,6,6,298.945
2054,17,5,12,5,94.24358333333335
2055,182,48,109,73,161.70734781700102
2056,54,10,32,22,197.9478860585402
2059,10,3,8,2,1096.3438888888888
2060,120,29,60,60,80.03468430715198
2061,21,8,13,8,149.48535300925926
2062,16,11,13,3,212.2033101851852
2063,26,6,19,7,630.5404371693122
2065,132,19,67,65,47.689951188635696
2066,38,13,20,18,27.963746141975307
2067,4,2,2,2,311.57659722222223
2068,11,2,7,4,105.32012345679011
2070,5,2,4,1,1020.636875
2071,8,4,4,4,75.57524305555556
2072,10,3,6,4,289.3918827160494
2073,36,9,19,17,143.51183127572014
2075,5,3,3,2,252.0
2076,11,3,6,5,441.4563580246913
2077,827,83,413,414,73.73158077555416
2078,27,12,15,12,545.1190946502057
2079,20,6,14,6,181.29750771604938
2080,69,19,33,36,67.09606481481481
2081,319,35,185,134,94.48370605647371
2082,2,1,1,1,347.94055555555553
2083,15,7,8,7,427.802337962963
2084,26,11,14,12,211.84818686868692
2085,3,2,2,1,612.175
2086,6,2,3,3,101.78604166666666
2088,9,4,5,4,126.01791666666666
2089,155,21,79,76,97.86938852145795
2090,23,9,12,11,164.7702901234568
2091,3,1,2,1,40.33851851851852
2092,8,5,6,2,4.121458333333334
2093,187,10,95,92,15.425387960087416
2094,15,5,9,6,149.76515432098765
2095,207,19,145,62,63.231322360961926
2096,560,56,277,283,61.24457801359024
2097,17,3,10,7,443.60515361952866
2098,12,6,8,4,0.12814814814814815
2099,4,1,2,2,210.00006944444445
2100,12,4,8,4,489.96830555555556
2101,13,6,7,6,416.28222222222223
2102,3,1,2,1,41.95444444444444
2103,9,4,7,2,353.8094791666667
2104,5,3,3,2,731.7500694444444
2106,8,5,6,2,84.97798611111111
2107,342,47,186,156,62.91361330234852
2108,7,3,4,3,128.9229012345679
2110,28,11,15,13,51.253023148148145
2111,96,13,50,46,110.51628376068376
2112,32,10,16,16,47.581997685185186
2113,13,4,8,5,107.31839583333334
2114,10,1,4,6,225.6887777777778
2115,437,44,238,199,98.67930520459996
2116,168,22,90,78,115.8223167178161
2117,9,3,5,4,113.05380401234568
2120,16,9,9,7,50.18007936507937
2121,2,1,1,1,12.0
2122,44,11,22,22,4.942262205387205
2125,4,2,3,1,0.7156944444444444
2126,16,6,8,8,230.27477623456787
2127,53,20,27,26,141.36758773148148
2128,172,17,89,83,70.69129820206642
2129,95,10,58,37,36.78491718023692
2130,77,27,71,6,259.1568446869489
2131,29,6,25,4,367.7627835097001
2132,14,3,11,3,349.0435185185185
2133,281,35,157,124,41.88230978747574
2135,33,13,21,12,239.77003347578346
2137,56,6,51,5,169.94123877068557
2138,20,7,11,9,151.66160383597887
2139,285,65,142,143,69.39470289556124
2140,40,3,19,21,143.81815861992945
2141,15,3,11,4,369.7716087962963
2142,26,6,18,8,402.401371031746
2143,13,7,8,5,180.1872314814815
2144,43,6,27,16,377.2571173747276
2145,9,4,5,4,414.340787037037
2146,108,10,64,44,90.76904210557962
2147,3,1,2,1,191.91185185185188
2148,60,10,36,24,257.6912330013094
2149,16,4,8,8,248.2875165343915
2150,8,5,6,2,285.5588888888889
2152,45,14,25,20,62.34238381410257
2153,37,27,31,6,409.09195312500003
2154,14,6,8,6,349.12109567901234
2155,10,4,6,4,71.02961805555556
2156,10,4,6,4,297.76060185185185
2157,7,2,4,3,609.7695138888889
2158,10,3,5,5,561.5460648148147
2159,173,29,97,76,105.25608998943574
2160,7,3,4,3,1317.0633333333335
2161,4,2,2,2,16.86826388888889
2162,5,4,4,1,181.11388888888888
2163,27,5,14,13,115.23882407407409
2164,88,23,44,44,10.122008856682772
2165,4,3,3,1,816.01875
2166,585,45,337,248,86.72628791270434
2167,83,25,43,40,82.08052706349207
2168,61,14,36,25,113.98424340199043
2170,37,10,19,18,222.48832428451178
2171,134,15,104,30,96.15961953463203
2174,27,5,15,12,99.30733741830065
2176,4,2,2,2,479.4614583333333
2177,11,5,6,5,101.43792592592592
2179,21,9,11,10,211.7325128600823
2181,15,5,9,6,84.26188703703704
2182,29,9,15,14,202.89964043209875
2183,36,11,19,17,458.1816923400674
2184,115,32,60,55,33.29942391079695
2185,11,3,7,4,616.5887808641975
2186,34,7,32,2,213.22056316137565
2187,7,3,5,2,709.5517592592593
2188,18,9,10,8,176.59108217592592
2190,755,55,389,366,46.53059485083467
2191,113,27,57,56,28.447297668038416
2192,23,11,12,11,62.29633333333334
2193,7,3,4,3,222.14706790123455
2194,11,4,6,5,481.8158564814815
2195,23,2,12,11,45.01501157407408
2196,58,12,43,15,239.26677188552188
2197,11,3,5,6,0.13169973544973546
2198,1289,49,839,450,52.75421265561221
2199,5,1,3,2,244.80027777777778
2200,10,5,5,5,458.7641111111111
2201,32,8,17,15,155.42049107142856
2203,10,8,9,1,192.3636111111111
2204,4,2,2,2,582.0341666666667
2205,48,7,25,23,119.64158575837743
2206,20,6,14,6,310.1954320987654
2207,57,14,31,26,254.6713971131382
2208,11,5,6,5,308.4348784722222
2209,132,25,73,59,45.70030626435544
2210,21,6,13,8,192.3398353174603
2211,683,55,422,261,51.45705024489994
2212,7,2,5,2,304.38072222222223
2214,41,11,24,17,14.217339365881033
2215,17,9,14,3,952.4809074074074
2216,7,4,6,1,0.5196990740740741
2217,2,1,1,1,432.0001388888889
2218,15,6,8,7,39.63609722222222
2219,72,18,41,31,208.0377609540344
2221,12,5,6,6,104.27479629629629
2223,20,7,11,9,7.828248456790123
2224,181,12,90,91,46.623959393249635
2225,24,7,23,1,32.71527777777778
2226,2,1,1,1,12.000277777777777
2227,24,10,12,12,64.83804166666667
2228,46,9,32,14,5.361394851290686
2229,6,4,4,2,0.06340277777777778
2230,56,6,44,12,221.03684027777777
2231,100,21,58,42,87.32192338944125
2232,32,10,16,16,122.26696527777779
2233,7,4,6,1,3.231527777777778
2234,8,4,4,4,621.0039236111112
2235,18,5,17,1,581.1608842592593
2236,3,2,2,1,575.9997222222222
2237,38,9,24,14,143.12988940329217
2239,13,5,7,6,152.6876898148148
2241,2,1,1,1,528.8175
2242,146,14,85,61,208.21971905219533
2243,5,1,3,2,87.2148888888889
2244,14,5,7,7,273.02695833333337
2245,73,18,38,35,220.97544481046216
2247,13,4,7,6,129.1278869047619
2248,3,1,2,1,8.89425925925926
2249,20,9,11,9,279.8735905349794
2251,22,7,11,11,384.74999999999994
2252,105,19,59,46,73.63101767900143
2253,3,2,2,1,0.5769444444444445
2254,4,2,2,2,36.096666666666664
2255,23,5,17,6,419.8269814814814
2256,3,1,2,1,80.0
2257,14,6,7,7,192.14024305555554
2259,3,2,2,1,453.455
2261,2,1,1,1,12.000555555555556
2262,8,4,4,4,322.0040972222222
2264,19,4,10,9,154.06372632575759
2265,23,10,12,11,184.85215046296295
2266,15,5,8,7,167.59175396825395
2268,98,23,49,49,69.74115562097423
2269,4,2,3,1,248.1783333333333
2270,482,55,298,184,67.98440030971443
2271,4,2,2,2,112.79520833333333
2272,4,1,1,3,83.68986111111111
2273,52,10,29,23,9.127641349902536
2274,48,10,36,12,219.92500092592596
2275,108,25,61,47,68.69164949845678
2276,391,62,206,185,62.846200138466735
2277,55,22,32,23,373.216362745098
2278,13,6,7,6,132.38854938271606
2279,9,6,6,3,215.90342592592594
2280,6,3,3,3,243.67972222222224
2281,24,9,14,10,423.23040637860083
2282,30,5,18,12,119.21147925569801
2283,5,3,4,1,1146.1433333333334
2284,77,15,39,38,49.109162962962955
2285,13,3,9,4,92.325625
2286,9,3,5,4,5.298953703703703
2287,33,16,17,16,115.98905555555555
2288,84,12,49,35,55.53535839546256
2289,23,7,12,11,108.24758201058202
2290,43,8,26,17,212.30729127209594
2291,43,13,30,13,180.47556818181818
2292,8,3,4,4,6.441342592592593
2293,12,7,8,4,321.5793611111111
2294,10,4,6,4,540.5261921296296
2295,9,5,5,4,231.02281250000001
2297,17,6,9,8,144.98012037037037
2298,3,2,2,1,2.108888888888889
2299,29,3,15,14,83.2644799382716
2300,130,35,67,63,38.18815094396344
2301,24,8,23,1,604.9406076388889
2303,72,26,38,34,59.69773842592593
2304,26,7,15,11,181.31922760770973
2305,20,11,12,8,205.9449826388889
2306,39,7,32,7,236.99254894179893
2307,13,5,7,6,140.1438425925926
2308,46,15,25,21,52.7533762345679
2309,123,7,61,62,23.729769160040497
2310,24,6,15,9,139.0391141975309
2312,11,4,6,5,17.55376736111111
2313,6,3,4,2,246.88689814814816
2314,16,6,9,7,160.30885555555557
2315,126,27,94,32,112.60144116583004
2316,8,4,5,3,47.04996913580248
2317,38,12,22,16,97.07633937757201
2318,58,15,30,28,57.13088390313391
2319,5,3,3,2,813.4380555555556
2321,3,2,2,1,1070.7268055555555
2322,192,10,98,94,46.274155061440844
2323,21,11,11,10,73.12358333333334
2324,176,12,90,86,49.6378732016513
2325,16,4,11,5,69.74523148148148
2326,19,7,10,9,29.805879629629633
2327,103,36,63,40,70.82683891612201
2328,9,5,6,3,0.9340277777777778
2329,72,6,65,7,98.93441416215109
2330,74,18,38,36,43.38216672178131
2331,20,8,12,8,59.14936921296297
2333,127,17,62,65,57.3542954929398
2334,182,40,96,86,34.518711299136825
2336,45,3,18,27,116.4555005144033
2337,34,11,16,18,85.1547037037037
2338,35,13,18,17,20.566315586419755
2339,8,2,4,4,16.567199074074075
2340,27,10,16,11,330.2361226851852
2341,2,1,1,1,433.1476388888889
2342,23,7,12,11,98.57877711640211
2343,12,6,7,5,0.2637885802469136
2344,17,7,10,7,191.0535030864198
2345,3,1,2,1,168.54722222222222
2346,371,32,190,181,59.3753515511582
2347,2,1,1,1,0.9593055555555555
2348,18,11,13,5,1069.2254761904762
2349,6,2,3,3,210.4884375
2350,3,2,2,1,0.6784722222222223
2351,109,29,59,50,17.562614717788826
2352,18,7,10,8,391.4265410052911
2353,29,9,15,14,16.92239351851852
2354,15,6,9,6,9.985092592592594
2355,8,5,5,3,16.10699074074074
2356,2,1,1,1,1.0815277777777779
2357,2,1,1,1,407.21694444444444
2358,31,13,16,15,105.11154736467236
2359,3,2,2,1,120.41055555555556
2361,10,5,5,5,221.67902777777778
2362,8,3,4,4,20.245555555555555
2363,130,21,66,64,5.1088225413622235
2364,13,4,8,5,171.91556712962964
2365,9,4,5,4,155.57082175925925
2366,28,10,16,12,339.49858539094646
2367,28,5,17,11,103.53306666666667
2368,177,22,91,86,16.530348366493666
2369,109,16,55,54,47.965533637152774
2370,4,1,2,2,378.07243055555557
2371,60,23,34,26,35.277190972222215
2372,13,5,7,6,72.87440000000001
2373,4,2,2,2,0.33013888888888887
2374,9,6,6,3,12.057638888888889
2376,40,10,21,19,65.66335452279202
2377,51,14,26,25,76.09960292022791
2378,5,2,3,2,458.6392824074074
2379,41,15,23,18,101.53068981481482
2380,51,14,49,2,94.60353936187268
2381,13,2,11,2,174.92195105820105
2382,331,8,180,151,21.54006881561952
2383,23,4,12,11,52.5297995580808
2384,25,9,15,10,268.96431349206347
2385,8,3,5,3,397.94899305555555
2386,17,8,8,9,476.0230729166667
2387,69,12,40,29,92.44228993807117
2388,9,3,5,4,46.44089814814814
2389,73,25,43,30,66.9195698148148
2390,9,5,7,2,159.02260416666667
2391,12,5,6,6,150.23674999999997
2392,9,5,5,4,3.074791666666667
2394,7,5,5,2,245.90854166666668
2395,7,3,4,3,466.4847839506173
2396,34,3,17,17,16.753519570707073
2397,16,9,12,4,322.4615694444445
2398,60,10,30,30,7.191320138888889
2399,39,10,25,14,90.04692126322752
2400,97,9,57,40,62.845474078480116
2401,74,14,39,35,129.69201034625704
2402,37,8,28,9,52.31494916855631
2403,51,16,25,26,33.4776662808642
2404,3,2,2,1,0.013472222222222222
2405,71,22,37,34,22.734545382968
2406,16,4,8,8,74.30461805555555
2407,3,2,2,1,0.5147222222222222
2408,20,5,18,2,198.00297407407407
2409,2,1,1,1,0.05263888888888889
2411,262,48,159,103,26.17409961486668
2412,14,6,7,7,59.775312500000005
2413,3,1,2,1,73.05296296296297
2414,67,26,37,30,76.69886502849003
2416,15,7,12,3,171.30520061728396
2417,6,2,3,3,45.483263888888885
2418,8,4,4,4,623.434826388889
2419,14,4,11,3,298.43638888888887
2420,13,4,7,6,35.28230158730159
2421,17,6,9,8,232.4719675925926
2423,42,14,20,22,87.01888492063493
2424,261,47,156,105,69.61833247703639
2426,216,23,123,93,63.02632869069137
2427,7,3,4,3,351.893549382716
2428,2,1,1,1,0.16722222222222222
2429,24,7,17,7,129.08164285714284
2432,6,3,4,2,0.10212962962962963
2433,22,10,20,2,386.02055555555563
2434,3,1,2,1,496.44175925925924
2437,121,14,64,57,19.71171371760955
2438,5,2,4,1,210.301875
2439,9,8,8,1,85.83958333333334
2440,276,53,138,138,33.18888643136859
2441,653,61,418,235,57.4625821493479
2442,5,4,4,1,1007.9701388888889
2444,20,5,11,9,100.61824629629629
2445,26,13,13,13,235.38821581196584
2446,9,2,6,3,74.42550595238095
2447,42,6,31,11,16.48783989197531
2448,6,4,4,2,28.780347222222222
2449,28,12,15,13,110.95196464646465
2450,3,1,2,1,0.13175925925925927
2452,9,3,5,4,51.988958333333336
2454,16,6,9,7,9.19312114197531
2455,12,3,9,3,1.472037037037037
2456,83,15,42,41,22.580630138380137
2457,51,16,30,21,8.59460462962963
2458,9,5,7,2,37.16538194444445
2460,3,2,2,1,11.669583333333334
2461,54,4,29,25,39.021436738070356
2462,21,7,11,10,85.3044386574074
2463,4,2,2,2,437.60993055555554
2464,6,3,3,3,329.0710185185185
2465,12,4,6,6,68.98531084656085
2466,12,4,6,6,49.655902777777776
2468,71,21,42,29,40.282686759889145
2469,23,8,13,10,73.77897511574074
2470,19,9,11,8,193.1793187830688
2472,12,5,7,5,113.04644444444446
2473,7,3,4,3,225.18604166666665
2474,11,4,7,4,154.35787962962962
2475,45,18,24,21,47.352259259259256
2476,5,2,4,1,337.3177314814815
2477,2,1,1,1,0.14527777777777778
2478,8,2,5,3,364.97725925925926
2479,5,1,3,2,187.2
2480,2,1,1,1,12.0
2481,5,4,4,1,155.49375
2482,10,2,5,5,1.6078645833333334
2483,10,2,6,4,7.7818402777777775
2484,52,13,25,27,8.056604884557373
2487,15,5,9,6,85.44327777777778
2488,16,10,15,1,356.23394444444443
2489,11,4,7,4,76.28348379629631
2490,5,3,3,2,275.42229166666664
2491,10,4,6,4,48.982280092592596
2492,16,8,9,7,118.7416512345679
2493,13,4,11,2,26.89411458333333
2494,2,1,1,1,35.630833333333335
2496,3,2,2,1,443.9998611111111
2497,34,16,20,14,163.4134861111111
2498,12,5,7,5,351.1356828703704
2499,11,6,6,5,93.5496388888889
2500,634,42,429,205,17.336221637681632
2501,99,24,74,25,61.38778488756614
2502,6,3,4,2,280.0
2504,28,12,17,11,119.55074074074075
2505,3,1,2,1,465.44777777777773
2507,2,1,1,1,36.00013888888889
2508,94,22,49,45,49.483871862565046
2509,7,2,4,3,0.03636111111111111
2510,14,7,7,7,58.31585317460317
2512,4,2,3,1,128.13074074074075
2513,9,5,7,2,9.205625000000001
2514,4,2,2,2,222.40881944444445
2516,99,28,48,51,57.59844597705535
2517,2,1,1,1,204.4038888888889
2518,18,7,13,5,127.43031746031747
2519,8,2,5,3,206.12103174603175
2520,41,17,24,17,44.716796296296295
2521,147,37,83,64,22.633395443997873
2523,21,7,11,10,123.26206150793651
2524,22,8,17,5,149.07958201058202
2525,11,6,6,5,60.42227777777778
2526,35,12,22,13,141.27030555555555
2527,233,34,136,97,19.898112707072
2528,459,135,296,163,101.8401007730483
2529,13,5,10,3,93.16453703703704
2530,6,3,3,3,11.38162037037037
2531,7,4,5,2,150.62613425925926
2532,10,4,5,5,162.53810185185185
2533,2,1,1,1,2.3356944444444445
2534,102,15,58,44,65.68521909067364
2535,12,7,8,4,321.6358564814815
2536,12,9,9,3,76.61773148148148
2537,16,6,10,6,375.8829552469135
2538,32,19,19,13,139.5028952991453
2539,2,1,1,1,0.051111111111111114
2540,94,16,55,39,71.15270930335097
2541,4,1,2,2,305.8905555555556
2543,88,26,48,40,56.84425496031747
2544,30,9,15,15,32.26250900205761
2545,29,7,21,8,59.02289517195768
2546,169,83,95,74,78.50058074618735
2547,2,1,1,1,0.08430555555555555
2548,112,29,60,52,33.13382797390987
2550,13,4,6,7,13.9575
2552,17,8,12,5,53.48295138888889
2553,9,7,7,2,324.0538888888889
2554,7,3,4,3,211.30308641975307
2556,8,5,5,3,337.3612037037037
2557,87,30,46,41,29.913220117845114
2558,12,4,8,4,245.18659722222225
2559,4,2,2,2,6.2225
2560,42,15,25,17,37.31521913580247
2561,11,5,6,5,6.641416666666667
2562,23,17,19,4,359.6623148148148
2563,3,1,2,1,0.2288888888888889
2564,20,8,11,9,25.408703703703704
2565,6,3,4,2,256.18967592592594
2566,9,5,5,4,16.566354166666667
2567,262,34,145,117,11.724007634650262
2569,3,1,2,1,24.0
2570,10,6,8,2,62.86779320987654
2571,57,17,31,26,20.566464752567693
2572,14,6,13,1,276.20576851851854
2573,619,70,362,257,21.059715547699092
2575,8,2,5,3,98.95142361111111
2576,5,2,3,2,60.6575
2577,66,8,39,27,25.173740530881158
2578,27,12,14,13,61.432899305555544
2579,19,10,11,8,19.960989583333333
2580,37,13,22,15,5.103514423076922
2581,16,4,9,7,30.727754629629633
2582,19,11,12,7,27.052857142857142
2583,11,6,6,5,64.5198888888889
2585,25,7,14,11,55.47035082972583
2586,4,1,2,2,0.6149305555555555
2587,5,2,4,1,0.3996296296296296
2589,19,6,16,3,224.15767962962963
2590,6,5,5,1,0.4701388888888889
2592,21,11,13,8,115.77908436213991
2593,12,6,7,5,67.99997222222223
2596,33,11,18,15,104.17709722222223
2597,5,3,4,1,0.22314814814814812
2598,4,2,2,2,200.19175925925924
2599,11,4,7,4,84.44716666666667
2600,11,3,6,5,61.48918981481481
2601,17,9,13,4,204.25760030864197
2603,36,12,18,18,11.704519675925924
2605,37,9,20,17,2.5582477904040406
2606,59,15,30,29,8.05802160493827
2608,19,3,11,8,55.65994543650793
2609,4,2,3,1,0.128125
2611,10,4,5,5,92.86996527777778
2613,9,4,5,4,0.6631944444444444
2614,7,6,6,1,2.0680555555555555
2615,6,3,4,2,0.9589583333333334
2619,11,3,8,3,103.46980555555554
2620,49,14,27,22,40.330929941421005
2621,13,8,10,3,51.194259259259255
2622,4,2,2,2,0.03361111111111111
2623,2,1,1,1,0.86
2624,14,5,11,3,46.24841319444444
2625,2,1,1,1,1.1227777777777779
2627,29,10,14,15,34.65221296296297
2628,80,36,44,36,16.73606005291005
2630,5,3,3,2,1.114861111111111
2633,15,8,8,7,79.10482142857144
2634,16,6,9,7,47.108032407407414
2636,15,9,14,1,163.15791666666667
2638,6,3,4,2,0.886435185185185
2639,13,4,7,6,42.19506944444444
2641,9,8,8,1,1.2648611111111112
2642,4,2,2,2,77.25243055555555
2643,9,4,7,2,43.29601851851852
2644,33,10,19,14,71.05491111111111
2645,5,3,3,2,58.772222222222226
2646,3,2,2,1,0.6270833333333333
2647,39,15,25,14,48.776573082010586
2648,22,3,12,10,38.266842592592596
2649,11,3,9,2,17.246929012345678
2651,7,4,5,2,0.6327777777777778
2652,5,2,3,2,20.017384259259256
2655,30,10,16,14,24.663067129629628
2657,13,6,7,6,26.37604166666667
2660,4,2,2,2,252.0
2661,8,3,6,2,137.10575
2664,6,3,4,2,72.14729166666666
2665,13,5,8,5,4.877538888888888
2666,12,6,6,6,42.56199074074074
2668,6,3,4,2,44.72944444444445
2669,6,4,4,2,4.877013888888889
2670,38,13,30,8,55.737808922558926
2671,15,4,9,6,5.262991898148147
2672,8,4,4,4,6.7754513888888885
2673,13,4,7,6,33.126443452380954
2674,9,4,5,4,2.7600231481481483
2675,9,4,5,4,5.07738425925926
2677,17,9,9,8,13.547534722222224
2678,7,4,4,3,12.605000000000002
2680,12,5,7,5,116.98169560185187
2683,14,4,7,7,73.76985532407407
2684,11,5,7,4,54.61302083333334
2685,55,18,32,23,1.3331856261022927
2687,13,6,8,5,48.011333333333326
2690,3,2,2,1,61.62847222222222
2693,10,3,7,3,32.150875
2694,19,9,10,9,31.598958333333332
2695,20,10,17,3,10.696481481481483
2696,48,14,41,7,11.224263685388687
2698,9,2,5,4,18.262013888888887
2700,15,6,9,6,5.475212962962963
