identifier,Number of trading,Number of trading symbol,Number of buy,Number of sell,Trading frequency,Cluster
1,3,1,2,1,55.394352,Cluster 3
3,11,4,6,5,965.51984,Cluster 3
7,2,1,1,1,47.352917,Cluster 3
8,55,4,52,3,615.07227,Cluster 3
10,551,9,275,276,26.83296,Cluster 3
11,38,11,21,17,385.07874,Cluster 3
12,58,9,40,18,470.21075,Cluster 3
15,20,5,14,6,219.45302,Cluster 3
16,8,4,4,4,36.212082,Cluster 3
18,17,4,12,5,336.31277,Cluster 3
19,16,4,8,8,1079.7682,Cluster 3
20,51,19,28,23,104.37344,Cluster 3
21,186,24,109,77,390.52716,Cluster 3
23,35,12,19,16,199.0773,Cluster 3
25,41,10,25,16,251.7189,Cluster 3
26,37,7,31,6,533.223,Cluster 3
27,2,1,1,1,72.000694,Cluster 3
29,66,3,51,15,213.69238,Cluster 3
30,297,13,152,145,49.70117,Cluster 3
33,82,12,43,39,1051.2427,Cluster 3
39,43,13,26,17,1006.5428,Cluster 3
40,64,8,53,11,631.8712,Cluster 3
41,9,3,4,5,263.1932,Cluster 3
42,17,10,9,8,830.08563,Cluster 3
43,111,7,81,30,105.86766,Cluster 3
45,8,2,5,3,130.13063,Cluster 3
47,28,7,17,11,25.600407,Cluster 3
49,3,1,2,1,0.007222222,Cluster 3
50,2,1,1,1,0.27944446,Cluster 3
51,24,5,14,10,89.92549,Cluster 3
55,30,7,18,12,265.51825,Cluster 3
56,29,6,14,15,70.20759,Cluster 3
58,59,2,55,4,319.39752,Cluster 3
61,31,13,17,14,214.46365,Cluster 3
62,53,11,44,9,233.06935,Cluster 3
64,33,10,31,2,645.7783,Cluster 3
66,22,4,16,6,845.8603,Cluster 3
68,127,7,124,3,386.01486,Cluster 3
69,8,3,4,4,265.9783,Cluster 3
70,13,6,7,6,643.32623,Cluster 3
71,45,25,31,14,375.32394,Cluster 3
73,12,3,7,5,687.3349,Cluster 3
78,26,7,21,5,765.9538,Cluster 3
81,34,9,17,17,61.338882,Cluster 3
82,19,7,11,8,943.3648,Cluster 3
85,72,9,62,10,645.2667,Cluster 3
86,153,18,80,73,210.16872,Cluster 3
88,56,23,36,20,1164.0994,Cluster 3
91,17,9,10,7,973.8301,Cluster 3
93,25,5,15,10,492.1097,Cluster 3
94,229,21,118,111,63.252285,Cluster 3
95,72,16,44,28,518.4886,Cluster 3
96,48,14,25,23,536.805,Cluster 3
97,51,13,31,20,596.9944,Cluster 3
98,4,2,2,2,271.87112,Cluster 3
100,404,22,248,156,153.88185,Cluster 3
101,19,4,13,6,440.73727,Cluster 3
107,25,1,12,13,85.50996,Cluster 3
108,3,2,2,1,23.436388,Cluster 3
110,380,25,190,190,136.55513,Cluster 3
111,20,7,10,10,561.8007,Cluster 3
112,13,8,9,4,957.9027,Cluster 3
113,285,21,229,56,104.094795,Cluster 3
114,7,4,5,2,76.83611,Cluster 3
116,16,4,12,4,438.3185,Cluster 3
117,380,17,338,42,113.57727,Cluster 3
118,37,9,22,15,298.29004,Cluster 3
119,30,7,22,8,1071.5212,Cluster 3
120,160,14,80,80,149.39178,Cluster 3
122,20,5,14,6,78.185326,Cluster 3
123,168,23,111,57,303.4171,Cluster 3
124,83,16,46,37,97.12826,Cluster 3
126,216,22,147,69,96.39426,Cluster 3
127,14,4,7,7,354.96155,Cluster 3
129,126,10,93,33,342.24792,Cluster 3
130,139,16,84,55,16.083029,Cluster 3
133,26,10,15,11,268.19183,Cluster 3
134,134,29,80,54,169.65291,Cluster 3
135,43,12,19,24,435.45554,Cluster 3
136,52,8,41,11,206.24397,Cluster 3
137,205,13,180,25,163.90541,Cluster 3
138,7,3,4,3,173.342,Cluster 3
139,71,12,50,21,324.49832,Cluster 3
140,28,4,21,7,67.994514,Cluster 3
141,454,20,266,188,178.13702,Cluster 3
142,92,17,56,36,787.3441,Cluster 3
143,4,3,3,1,576.61725,Cluster 3
144,38,10,27,11,390.52374,Cluster 3
145,35,15,18,17,525.8652,Cluster 3
146,103,20,58,45,112.01146,Cluster 3
148,134,13,70,64,63.816875,Cluster 3
149,28,9,27,1,1057.4897,Cluster 3
150,32,6,16,16,9.178472,Cluster 3
152,7,5,6,1,54.621666,Cluster 3
154,525,21,481,44,237.5196,Cluster 3
155,17,9,11,6,424.09897,Cluster 3
162,50,14,26,24,213.51135,Cluster 3
163,80,14,48,32,676.2928,Cluster 3
165,130,23,75,55,132.45236,Cluster 3
168,97,9,92,5,627.5057,Cluster 3
169,20,11,12,8,521.4324,Cluster 3
170,33,4,29,4,654.16254,Cluster 3
171,111,6,102,9,619.24976,Cluster 3
172,27,5,20,7,509.159,Cluster 3
173,14,6,7,7,1032.9271,Cluster 3
174,27,10,14,13,764.23065,Cluster 3
175,15,2,7,8,257.6266,Cluster 3
176,2,1,1,1,0.5397222,Cluster 3
178,8,4,4,4,519.841,Cluster 3
181,208,8,184,24,177.47594,Cluster 3
182,322,33,166,156,122.314545,Cluster 3
184,28,4,21,7,318.94873,Cluster 3
185,6,3,3,3,759.34717,Cluster 3
186,61,20,30,31,213.36612,Cluster 3
187,66,14,28,38,345.86337,Cluster 3
188,237,35,129,108,95.024864,Cluster 3
190,38,6,24,14,278.45392,Cluster 3
191,40,8,37,3,759.85895,Cluster 3
193,17,7,9,8,393.14297,Cluster 3
194,44,5,36,8,336.168,Cluster 3
195,309,18,227,82,100.3868,Cluster 3
196,21,9,11,10,876.1186,Cluster 3
197,174,17,128,46,124.3296,Cluster 3
199,8,2,5,3,62.135834,Cluster 3
200,152,35,81,71,316.88882,Cluster 3
201,8,2,4,4,0.059907407,Cluster 3
202,20,4,14,6,407.0405,Cluster 3
203,14,3,8,6,323.8252,Cluster 3
209,46,10,27,19,354.72073,Cluster 3
210,9,3,6,3,538.9401,Cluster 3
213,12,5,6,6,160.67114,Cluster 3
214,337,17,258,79,223.07458,Cluster 3
215,19,4,9,10,115.89383,Cluster 3
216,142,16,110,32,196.82353,Cluster 3
217,17,4,12,5,459.09128,Cluster 3
218,27,10,16,11,71.781204,Cluster 3
220,10,5,9,1,11.334248,Cluster 3
223,5,2,3,2,555.9438,Cluster 3
227,11,4,6,5,684.9597,Cluster 3
228,137,25,72,65,37.693924,Cluster 3
229,39,5,20,19,490.0296,Cluster 3
230,13,4,7,6,711.4503,Cluster 3
232,14,3,8,6,258.07388,Cluster 3
233,31,7,16,15,208.18152,Cluster 3
234,10,4,5,5,103.10627,Cluster 3
236,10,4,5,5,900.47797,Cluster 3
238,21,10,11,10,20.615301,Cluster 3
240,82,10,70,12,542.1137,Cluster 3
241,6,4,4,2,0.15222222,Cluster 3
242,38,12,17,21,485.04196,Cluster 3
244,16,3,5,11,93.91363,Cluster 3
247,60,14,32,28,276.81927,Cluster 3
248,19,8,10,9,744.85376,Cluster 3
249,130,7,67,63,88.4885,Cluster 3
250,4,2,2,2,12.719722,Cluster 3
251,43,10,26,17,301.35672,Cluster 3
252,53,13,26,27,292.408,Cluster 3
254,102,13,51,51,24.384716,Cluster 3
257,16,2,11,5,22.198606,Cluster 3
258,304,11,160,144,154.98413,Cluster 3
259,13,2,11,2,23.429653,Cluster 3
261,29,5,16,13,512.97546,Cluster 3
263,7,3,3,4,581.5284,Cluster 3
264,18,4,10,8,171.9387,Cluster 3
267,3,2,2,1,1019.6468,Cluster 3
269,12,2,11,1,224.78914,Cluster 3
270,5,1,4,1,359.57104,Cluster 3
271,7,3,4,3,1023.0315,Cluster 3
272,4,2,2,2,12.259375,Cluster 3
273,470,18,415,55,203.97191,Cluster 3
275,4,1,2,2,156.00659,Cluster 3
278,13,2,9,4,559.00635,Cluster 3
280,79,14,40,39,145.82301,Cluster 3
281,146,7,87,59,113.19371,Cluster 3
282,56,9,32,24,23.330938,Cluster 3
283,24,6,10,14,132.93477,Cluster 3
284,4,3,3,1,1.0216666,Cluster 3
285,42,13,23,19,611.82007,Cluster 3
288,28,7,21,7,243.60616,Cluster 3
289,177,47,154,23,930.20886,Cluster 3
290,74,13,48,26,1015.21136,Cluster 3
292,84,9,69,15,256.39047,Cluster 3
295,36,6,29,7,509.62192,Cluster 3
296,22,11,14,8,297.33716,Cluster 3
297,50,9,46,4,883.78894,Cluster 3
298,58,9,38,20,969.7977,Cluster 3
299,336,16,215,121,333.05923,Cluster 3
300,19,6,11,8,371.32483,Cluster 3
302,30,4,16,14,160.83896,Cluster 3
303,5,2,3,2,108.30125,Cluster 3
304,12,5,7,5,96.484985,Cluster 3
306,240,25,172,68,238.38055,Cluster 3
307,37,11,21,16,349.60388,Cluster 3
308,8,2,4,4,9.125556,Cluster 3
309,31,7,22,9,140.89017,Cluster 3
311,182,20,138,44,468.03152,Cluster 3
312,71,9,31,40,247.20273,Cluster 3
313,9,2,5,4,444.12106,Cluster 3
314,228,27,117,111,236.2218,Cluster 3
315,16,4,14,2,344.62012,Cluster 3
316,30,3,19,11,500.302,Cluster 3
318,68,7,67,1,741.9875,Cluster 3
319,126,16,71,55,524.3638,Cluster 3
320,7,3,4,3,834.78674,Cluster 3
322,20,4,9,11,398.3247,Cluster 3
323,218,15,118,100,151.8897,Cluster 3
324,16,7,15,1,637.3305,Cluster 3
325,71,20,52,19,462.89978,Cluster 3
326,30,6,22,8,146.6922,Cluster 3
327,32,9,17,15,893.1372,Cluster 3
328,33,15,21,12,353.30737,Cluster 3
331,4,2,3,1,847.44794,Cluster 3
332,20,3,9,11,577.8649,Cluster 3
333,23,7,13,10,812.0083,Cluster 3
334,148,11,84,64,256.63184,Cluster 3
335,3,2,2,1,935.9999,Cluster 3
336,19,7,10,9,167.1459,Cluster 3
339,175,39,107,68,115.64351,Cluster 3
340,54,8,32,22,58.00765,Cluster 3
341,36,14,25,11,633.8361,Cluster 3
342,45,15,32,13,236.50336,Cluster 3
343,38,6,21,17,198.0438,Cluster 3
344,13,5,7,6,466.488,Cluster 3
347,50,13,27,23,10.178575,Cluster 3
348,11,4,7,4,440.9998,Cluster 3
349,2,1,1,1,480.00015,Cluster 3
350,13,3,7,6,172.51302,Cluster 3
352,55,15,25,30,108.88411,Cluster 3
354,7,3,3,4,193.77148,Cluster 3
355,31,6,17,14,466.42926,Cluster 3
356,297,34,223,74,309.19928,Cluster 3
357,13,4,7,6,242.82959,Cluster 3
358,202,38,118,84,107.00614,Cluster 3
359,107,12,87,20,443.86746,Cluster 3
362,151,37,82,69,710.15894,Cluster 3
363,102,13,57,45,135.203,Cluster 3
365,85,13,48,37,26.707994,Cluster 3
366,246,17,130,116,137.79886,Cluster 3
368,43,10,33,10,560.93134,Cluster 3
369,124,15,62,62,20.618996,Cluster 3
370,39,6,23,16,276.60632,Cluster 3
371,2,1,1,1,12.000139,Cluster 3
372,9,4,5,4,14.386262,Cluster 3
377,22,6,12,10,246.99757,Cluster 3
378,132,9,85,47,581.64716,Cluster 3
379,113,8,60,53,226.8768,Cluster 3
381,14,5,12,2,132.77283,Cluster 3
382,12,3,9,3,438.05933,Cluster 3
383,36,8,18,18,112.77604,Cluster 3
384,14,4,7,7,624.694,Cluster 3
385,69,13,36,33,213.30984,Cluster 3
387,34,6,28,6,458.14365,Cluster 3
390,29,4,27,2,454.113,Cluster 3
391,45,11,22,23,131.34099,Cluster 3
392,41,10,38,3,868.00824,Cluster 3
393,419,30,249,170,54.626392,Cluster 3
394,4,2,2,2,0.40888888,Cluster 3
395,24,6,15,9,282.35587,Cluster 3
396,13,4,8,5,590.88104,Cluster 3
398,52,10,28,24,146.16966,Cluster 3
399,23,8,15,8,611.9428,Cluster 3
400,263,20,132,131,308.97296,Cluster 3
401,3,2,2,1,516.36584,Cluster 3
402,339,28,173,166,78.64863,Cluster 3
403,6,3,3,3,222.64357,Cluster 3
404,11,5,7,4,864.8394,Cluster 3
405,110,9,68,42,402.85284,Cluster 3
406,47,3,24,23,92.8142,Cluster 3
407,101,29,61,40,321.57358,Cluster 3
408,325,38,184,141,298.71765,Cluster 3
409,304,30,154,150,41.120766,Cluster 3
410,2,1,1,1,636.0,Cluster 3
411,350,29,172,178,268.7915,Cluster 3
412,549,16,320,229,333.5279,Cluster 3
414,487,22,280,207,222.32944,Cluster 3
416,43,11,22,21,155.26355,Cluster 3
418,138,17,70,68,76.85055,Cluster 3
419,42,11,23,19,332.83484,Cluster 3
420,364,20,277,87,227.57202,Cluster 3
422,219,30,198,21,370.68323,Cluster 3
423,18,6,9,9,100.939445,Cluster 3
424,13,4,10,3,984.37714,Cluster 3
425,81,16,36,45,85.74658,Cluster 3
426,32,4,28,4,928.7435,Cluster 3
427,338,26,170,168,68.96379,Cluster 3
428,22,8,11,11,119.074066,Cluster 3
429,17,8,9,8,192.91394,Cluster 3
432,6,2,3,3,226.97278,Cluster 3
434,83,12,69,14,613.8506,Cluster 3
435,21,6,19,2,177.74312,Cluster 3
436,69,20,36,33,118.71544,Cluster 3
437,88,22,47,41,250.33601,Cluster 3
438,22,7,12,10,688.33813,Cluster 3
439,269,28,146,123,76.796906,Cluster 3
440,42,15,23,19,877.4629,Cluster 3
441,39,11,27,12,327.6256,Cluster 3
444,174,32,81,93,137.65,Cluster 3
446,6,3,4,2,138.43892,Cluster 3
447,3,2,2,1,1043.4976,Cluster 3
448,266,31,153,113,288.98184,Cluster 3
451,76,17,51,25,663.0594,Cluster 3
452,38,13,19,19,308.31985,Cluster 3
453,77,13,37,40,33.42206,Cluster 3
454,28,9,18,10,189.32858,Cluster 3
455,98,14,72,26,228.74449,Cluster 3
459,278,14,160,118,191.34537,Cluster 3
462,155,17,77,78,550.1216,Cluster 3
463,39,11,20,19,82.596695,Cluster 3
464,167,10,84,83,60.669483,Cluster 3
465,11,5,5,6,747.84863,Cluster 3
466,33,11,25,8,718.9244,Cluster 3
468,9,5,5,4,1059.0525,Cluster 3
470,24,5,19,5,286.05334,Cluster 3
471,37,8,31,6,613.177,Cluster 3
472,44,6,36,8,645.5778,Cluster 3
473,14,4,10,4,831.1414,Cluster 3
474,40,4,24,16,155.46118,Cluster 3
475,102,6,51,51,44.00342,Cluster 3
476,66,7,62,4,830.21533,Cluster 3
477,27,8,16,11,567.09216,Cluster 3
480,120,13,59,61,161.90602,Cluster 3
481,18,4,13,5,667.15564,Cluster 3
482,47,6,42,5,877.17645,Cluster 3
483,11,4,6,5,506.40448,Cluster 3
485,6,4,4,2,252.65298,Cluster 3
489,6,2,4,2,64.31704,Cluster 3
490,18,6,11,7,15.561855,Cluster 3
491,3,2,2,1,227.79306,Cluster 3
492,13,6,7,6,339.27548,Cluster 3
493,326,31,158,168,143.96684,Cluster 3
494,10,1,6,4,796.7192,Cluster 3
495,8,3,5,3,879.4671,Cluster 3
496,152,17,123,29,181.94182,Cluster 3
498,34,8,17,17,97.6154,Cluster 3
500,262,16,184,78,203.87045,Cluster 3
501,13,4,6,7,247.29257,Cluster 3
503,19,8,10,9,291.2213,Cluster 3
504,30,8,18,12,465.61234,Cluster 3
505,45,3,34,11,108.96799,Cluster 3
506,28,5,13,15,340.1425,Cluster 3
508,46,12,25,21,188.34581,Cluster 3
509,34,9,19,15,238.24574,Cluster 3
512,51,12,31,20,788.91876,Cluster 3
515,23,9,12,11,44.524937,Cluster 3
520,18,6,7,11,407.84866,Cluster 3
521,8,3,4,4,236.00874,Cluster 3
523,21,5,13,8,788.4853,Cluster 3
524,4,2,2,2,965.7474,Cluster 3
525,23,6,12,11,235.5466,Cluster 3
526,107,18,66,41,83.63839,Cluster 3
527,27,6,14,13,353.89957,Cluster 3
528,20,7,14,6,178.18419,Cluster 3
529,62,14,26,36,311.43503,Cluster 3
530,98,10,48,50,272.07693,Cluster 3
534,19,5,17,2,451.1446,Cluster 3
536,33,9,13,20,421.04202,Cluster 3
537,6,4,4,2,174.56667,Cluster 3
538,263,14,257,6,648.5856,Cluster 3
540,8,2,3,5,557.8652,Cluster 3
541,56,11,41,15,44.735394,Cluster 3
542,22,3,11,11,445.0125,Cluster 3
544,140,11,120,20,298.7679,Cluster 3
545,10,7,8,2,128.52634,Cluster 3
547,40,7,20,20,332.4119,Cluster 3
548,26,10,13,13,191.06323,Cluster 3
550,11,3,6,5,32.872517,Cluster 3
551,74,19,45,29,75.11071,Cluster 3
555,27,7,17,10,709.4881,Cluster 3
556,12,4,10,2,952.88574,Cluster 3
557,5,2,3,2,591.9081,Cluster 3
559,3,2,2,1,840.5,Cluster 3
560,8,3,4,4,3.6066551,Cluster 3
562,206,8,186,20,136.89008,Cluster 3
565,175,10,95,80,420.44696,Cluster 3
566,42,14,25,17,385.92435,Cluster 3
567,41,12,19,22,174.4039,Cluster 3
568,10,4,6,4,730.95233,Cluster 3
570,10,3,8,2,119.782745,Cluster 3
572,41,12,17,24,556.4014,Cluster 3
573,19,12,17,2,1021.28064,Cluster 3
575,5,2,3,2,608.2363,Cluster 3
576,195,26,110,85,194.48773,Cluster 3
577,15,10,12,3,199.73436,Cluster 3
578,18,4,9,9,102.25312,Cluster 3
579,166,26,119,47,191.1736,Cluster 3
580,40,6,28,12,915.26526,Cluster 3
581,50,12,26,24,514.42334,Cluster 3
583,17,8,9,8,211.70715,Cluster 3
584,19,8,10,9,268.70422,Cluster 3
585,3,1,2,1,64.0,Cluster 3
586,8,2,7,1,1031.986,Cluster 3
588,2,1,1,1,0.103194445,Cluster 3
589,76,20,42,34,2.9963522,Cluster 3
590,42,6,36,6,503.4236,Cluster 3
591,143,40,72,71,310.875,Cluster 3
592,14,4,7,7,121.84115,Cluster 3
593,59,9,25,34,336.47202,Cluster 3
594,5,2,3,2,27.999954,Cluster 3
595,17,6,10,7,197.57732,Cluster 3
597,82,21,45,37,335.21857,Cluster 3
598,69,13,61,8,531.02136,Cluster 3
600,54,8,42,12,628.6265,Cluster 3
601,17,4,9,8,41.726765,Cluster 3
602,80,17,29,51,390.42294,Cluster 3
603,78,7,64,14,578.4924,Cluster 3
604,7,3,4,3,747.26874,Cluster 3
605,11,2,8,3,145.15292,Cluster 3
606,38,17,26,12,931.4024,Cluster 3
607,40,3,31,9,700.9392,Cluster 3
608,18,11,16,2,246.06786,Cluster 3
610,16,4,12,4,982.8082,Cluster 3
613,150,29,76,74,81.30263,Cluster 3
616,36,11,22,14,856.4458,Cluster 3
617,38,15,19,19,32.071465,Cluster 3
618,79,9,42,37,130.57802,Cluster 3
619,171,16,97,74,10.83115,Cluster 3
620,9,4,8,1,1005.88513,Cluster 3
621,7,6,6,1,0.107777774,Cluster 3
622,91,26,57,34,558.8673,Cluster 3
627,17,8,9,8,148.24529,Cluster 3
628,3,2,2,1,156.20805,Cluster 3
629,2,1,1,1,1.1143055,Cluster 3
630,3,1,2,1,0.19481482,Cluster 3
631,21,4,19,2,670.64056,Cluster 3
632,18,5,7,11,841.00604,Cluster 3
633,63,20,33,30,461.84418,Cluster 3
636,10,3,6,4,158.73479,Cluster 3
637,23,8,12,11,127.37971,Cluster 3
638,40,7,22,18,479.38953,Cluster 3
640,5,3,4,1,0.61657405,Cluster 3
643,89,7,50,39,56.50893,Cluster 3
644,19,8,18,1,1157.3175,Cluster 3
645,8,4,4,4,144.23146,Cluster 3
646,34,5,27,7,267.75284,Cluster 3
651,194,36,110,84,399.30655,Cluster 3
652,30,5,16,14,194.07872,Cluster 3
655,92,16,47,45,244.10991,Cluster 3
656,28,4,20,8,604.94135,Cluster 3
657,15,6,8,7,942.1594,Cluster 3
659,19,3,9,10,313.58978,Cluster 3
660,484,19,393,91,175.48273,Cluster 3
661,49,8,47,2,1119.5242,Cluster 3
662,53,8,36,17,657.24335,Cluster 3
663,38,14,22,16,715.4017,Cluster 3
664,209,16,105,104,74.08613,Cluster 3
665,41,14,23,18,168.06352,Cluster 3
666,67,14,39,28,806.8192,Cluster 3
669,40,13,27,13,916.456,Cluster 3
671,32,6,20,12,646.6107,Cluster 3
672,9,3,4,5,721.2234,Cluster 3
673,28,9,15,13,647.658,Cluster 3
674,3,1,2,1,15.826574,Cluster 3
676,24,3,18,6,740.14435,Cluster 3
678,26,11,14,12,566.76843,Cluster 3
679,7,3,4,3,5.86054,Cluster 3
680,15,7,8,7,90.186676,Cluster 3
681,61,17,27,34,2.2172441,Cluster 3
682,17,2,10,7,294.60272,Cluster 3
683,120,13,106,14,446.53613,Cluster 3
684,56,20,31,25,1020.58167,Cluster 3
685,526,26,382,144,44.1494,Cluster 3
687,49,5,26,23,124.21108,Cluster 3
690,7,5,6,1,0.32037038,Cluster 3
693,21,8,14,7,975.3625,Cluster 3
694,57,8,28,29,21.726774,Cluster 3
695,19,9,10,9,556.8902,Cluster 3
696,3,1,2,1,21.924353,Cluster 3
697,48,8,27,21,346.18707,Cluster 3
698,19,3,11,8,102.19018,Cluster 3
699,8,5,7,1,79.94211,Cluster 3
701,13,2,11,2,534.23615,Cluster 3
703,7,4,6,1,0.56722224,Cluster 3
704,148,34,75,73,63.891376,Cluster 3
710,100,26,51,49,506.62665,Cluster 3
712,29,3,26,3,607.6392,Cluster 3
714,32,13,21,11,228.47797,Cluster 3
716,22,9,14,8,337.33954,Cluster 3
719,3,1,2,1,480.07333,Cluster 3
720,318,26,215,103,128.82745,Cluster 3
722,69,19,40,29,260.65726,Cluster 3
723,13,4,9,4,512.4167,Cluster 3
724,2,1,1,1,0.26583335,Cluster 3
725,87,8,64,23,373.6847,Cluster 3
727,40,18,20,20,306.8374,Cluster 3
728,69,16,51,18,797.94415,Cluster 3
729,262,26,149,113,336.53094,Cluster 3
731,3,2,2,1,3.16625,Cluster 3
733,7,4,5,2,11.813426,Cluster 3
734,6,5,5,1,24.134306,Cluster 3
735,22,8,12,10,311.88513,Cluster 3
737,16,6,15,1,1099.7008,Cluster 3
738,5,2,3,2,375.99994,Cluster 3
740,25,12,14,11,693.53705,Cluster 3
741,61,8,49,12,724.43774,Cluster 3
742,9,2,4,5,262.03732,Cluster 3
744,9,2,4,5,509.74036,Cluster 3
747,39,12,20,19,230.45079,Cluster 3
748,35,7,18,17,7.5223556,Cluster 3
749,23,6,12,11,706.31525,Cluster 3
750,33,6,19,14,76.70764,Cluster 3
751,262,6,127,135,75.248116,Cluster 3
752,116,27,64,52,393.54495,Cluster 3
753,258,19,158,100,263.2518,Cluster 3
754,7,3,5,2,361.4928,Cluster 3
757,33,11,17,16,64.64924,Cluster 3
758,26,8,16,10,518.4889,Cluster 3
760,14,3,11,3,730.44653,Cluster 3
761,31,9,17,14,708.1414,Cluster 3
762,2,1,1,1,480.0,Cluster 3
764,2,1,1,1,324.6679,Cluster 3
765,52,7,27,25,580.82947,Cluster 3
767,99,22,50,49,475.15106,Cluster 3
770,47,12,26,21,19.912788,Cluster 3
771,82,5,62,20,380.1498,Cluster 3
773,100,20,53,47,30.127346,Cluster 3
774,13,4,9,4,1012.2981,Cluster 3
775,10,3,9,1,334.1498,Cluster 3
776,131,25,73,58,154.55069,Cluster 3
777,18,6,9,9,522.0093,Cluster 3
778,39,9,22,17,567.1534,Cluster 3
780,28,10,16,12,700.79425,Cluster 3
783,20,4,11,9,557.7946,Cluster 3
784,49,7,41,8,498.5298,Cluster 3
785,74,5,47,27,158.10515,Cluster 3
786,64,16,38,26,391.31497,Cluster 3
787,7,4,5,2,0.8521991,Cluster 3
789,29,10,16,13,132.45648,Cluster 3
792,33,9,17,16,736.396,Cluster 3
796,49,14,26,23,538.21735,Cluster 3
798,41,7,22,19,387.02948,Cluster 3
800,66,16,35,31,288.3485,Cluster 3
801,34,13,17,17,680.0507,Cluster 3
803,3,2,2,1,12.000139,Cluster 3
808,5,3,4,1,29.65007,Cluster 3
809,64,15,26,38,199.1051,Cluster 3
810,196,38,151,45,159.84427,Cluster 3
811,372,11,322,50,229.05247,Cluster 3
812,10,1,8,2,168.11108,Cluster 3
814,19,7,17,2,230.78114,Cluster 3
815,11,3,6,5,634.28503,Cluster 3
816,23,6,17,6,758.61285,Cluster 3
817,27,9,13,14,332.14215,Cluster 3
818,17,8,10,7,367.62988,Cluster 3
821,122,14,112,10,263.49695,Cluster 3
823,50,18,25,25,174.48318,Cluster 3
825,12,4,8,4,646.4112,Cluster 3
826,15,6,11,4,1126.2458,Cluster 3
827,41,18,26,15,773.87744,Cluster 3
828,12,5,6,6,795.6478,Cluster 3
829,26,7,14,12,753.4759,Cluster 3
830,256,20,127,129,45.091778,Cluster 3
834,16,4,11,5,382.2393,Cluster 3
838,219,36,113,106,174.08284,Cluster 3
839,183,8,172,11,128.73897,Cluster 3
840,59,11,33,26,246.73135,Cluster 3
843,5,3,4,1,296.3948,Cluster 3
844,31,9,16,15,102.36307,Cluster 3
845,96,15,49,47,213.68799,Cluster 3
846,54,7,47,7,725.4861,Cluster 3
847,51,11,27,24,259.1143,Cluster 3
848,9,4,7,2,860.27563,Cluster 3
849,287,36,144,143,83.74579,Cluster 3
850,32,16,29,3,225.08621,Cluster 3
851,251,27,137,114,76.59602,Cluster 3
853,19,11,18,1,510.62683,Cluster 3
854,18,8,10,8,903.66364,Cluster 3
856,22,4,12,10,941.32086,Cluster 3
857,21,7,11,10,1092.2456,Cluster 3
858,15,5,9,6,253.07346,Cluster 3
861,159,16,81,78,181.47742,Cluster 3
862,6,5,5,1,0.0725,Cluster 3
863,20,5,10,10,69.292046,Cluster 3
864,8,3,5,3,2.3314815,Cluster 3
865,14,3,8,6,131.79938,Cluster 3
866,54,14,40,14,565.7182,Cluster 3
867,23,7,13,10,10.535099,Cluster 3
869,264,41,134,130,64.075455,Cluster 3
871,30,11,15,15,569.16724,Cluster 3
872,3,1,2,1,80.0,Cluster 3
873,7,6,6,1,0.8601389,Cluster 3
874,88,28,54,34,974.9615,Cluster 3
875,10,4,5,5,90.03196,Cluster 3
876,97,5,79,18,317.7832,Cluster 3
877,2,1,1,1,0.08541667,Cluster 3
878,38,5,34,4,172.96541,Cluster 3
879,4,2,2,2,48.008335,Cluster 3
880,141,33,79,62,502.9405,Cluster 3
882,4,2,2,2,342.25006,Cluster 3
883,46,9,40,6,1028.3259,Cluster 3
885,24,11,14,10,722.9112,Cluster 3
886,47,8,25,22,706.1931,Cluster 3
887,75,20,46,29,17.209904,Cluster 3
888,9,5,8,1,1046.064,Cluster 3
889,6,1,3,3,932.0252,Cluster 3
890,319,29,243,76,168.54335,Cluster 3
891,24,6,18,6,615.9412,Cluster 3
892,16,6,8,8,530.3105,Cluster 3
893,12,5,6,6,893.9101,Cluster 3
894,51,14,26,25,278.56738,Cluster 3
897,16,6,8,8,86.927795,Cluster 3
899,27,6,26,1,935.6249,Cluster 3
901,4,3,3,1,0.091527775,Cluster 3
902,49,14,26,23,309.8669,Cluster 3
903,21,5,11,10,1101.4496,Cluster 3
905,3,2,2,1,72.20861,Cluster 3
910,34,16,31,3,474.06427,Cluster 3
911,17,6,9,8,813.3872,Cluster 3
912,178,43,105,73,311.65997,Cluster 3
913,209,32,86,123,12.295631,Cluster 3
914,8,4,7,1,125.93441,Cluster 3
916,18,3,10,8,243.05547,Cluster 3
917,74,16,45,29,17.638147,Cluster 3
918,96,13,78,18,573.50507,Cluster 3
920,42,7,21,21,158.40988,Cluster 3
921,87,18,47,40,278.49933,Cluster 3
922,24,8,16,8,803.07666,Cluster 3
924,154,34,76,78,105.7263,Cluster 3
925,62,14,51,11,979.23224,Cluster 3
926,16,5,8,8,1.4693241,Cluster 3
928,128,35,126,2,525.81824,Cluster 3
929,9,4,5,4,747.83795,Cluster 3
931,69,10,41,28,465.27533,Cluster 3
932,13,6,7,6,17.658913,Cluster 3
936,436,32,264,172,296.59564,Cluster 3
937,8,2,5,3,81.698006,Cluster 3
941,15,5,9,6,234.54007,Cluster 3
942,84,13,71,13,328.5696,Cluster 3
943,236,8,142,94,105.69762,Cluster 3
944,15,7,8,7,63.067432,Cluster 3
945,310,26,165,145,99.24361,Cluster 3
947,52,7,46,6,179.34929,Cluster 3
949,125,30,74,51,163.17578,Cluster 3
950,15,6,6,9,66.18665,Cluster 3
955,36,8,19,17,201.05173,Cluster 3
957,23,5,12,11,165.20683,Cluster 3
960,12,6,11,1,905.2591,Cluster 3
961,27,8,13,14,159.97894,Cluster 3
963,321,27,181,140,37.458187,Cluster 3
965,23,6,12,11,524.3004,Cluster 3
967,74,22,39,35,236.78972,Cluster 3
968,9,8,8,1,0.0095833335,Cluster 3
969,18,7,10,8,337.89835,Cluster 3
970,40,12,24,16,215.01562,Cluster 3
971,47,8,38,9,206.32347,Cluster 3
972,137,42,86,51,113.88061,Cluster 3
973,35,9,20,15,352.49048,Cluster 3
974,8,4,5,3,416.02045,Cluster 3
975,30,7,29,1,1000.2683,Cluster 3
977,173,14,122,51,273.90067,Cluster 3
978,17,9,14,3,165.81564,Cluster 3
979,20,9,12,8,578.6198,Cluster 3
980,56,8,30,26,34.4249,Cluster 3
981,84,8,70,14,648.1725,Cluster 3
984,52,18,28,24,20.356903,Cluster 3
985,44,18,26,18,71.677864,Cluster 3
986,65,14,37,28,171.93707,Cluster 3
987,18,4,9,9,534.0666,Cluster 3
990,52,13,31,21,272.56885,Cluster 3
991,80,13,57,23,68.01006,Cluster 3
993,6,3,4,2,1007.92554,Cluster 3
994,11,4,6,5,422.37067,Cluster 3
995,51,8,33,18,8.579393,Cluster 3
996,22,7,21,1,940.35376,Cluster 3
997,3,2,2,1,0.45,Cluster 3
998,28,11,18,10,53.206665,Cluster 3
1000,27,2,14,13,565.1539,Cluster 3
1001,78,31,42,36,682.1087,Cluster 3
1002,33,7,21,12,187.59056,Cluster 3
1003,20,8,11,9,117.82051,Cluster 3
1004,5,2,3,2,238.56792,Cluster 3
1005,30,8,18,12,714.988,Cluster 3
1006,23,12,12,11,215.0077,Cluster 3
1008,4,3,3,1,0.068333335,Cluster 3
1009,45,15,26,19,191.43274,Cluster 3
1012,13,4,7,6,167.65768,Cluster 3
1013,15,6,10,5,488.74237,Cluster 3
1014,31,14,16,15,368.02902,Cluster 3
1015,110,15,64,46,131.39055,Cluster 3
1021,81,7,60,21,632.7742,Cluster 3
1025,16,4,8,8,99.03666,Cluster 3
1026,116,15,108,8,255.9235,Cluster 3
1027,3,2,2,1,0.76569444,Cluster 3
1028,21,7,11,10,448.62073,Cluster 3
1029,60,14,57,3,496.31854,Cluster 3
1031,7,3,3,4,82.08177,Cluster 3
1032,9,5,5,4,758.80084,Cluster 3
1033,40,3,20,20,45.183517,Cluster 3
1034,96,18,52,44,160.98988,Cluster 3
1036,61,8,54,7,582.2694,Cluster 3
1037,6,3,3,3,56.566113,Cluster 3
1039,7,2,5,2,775.28265,Cluster 3
1040,7,3,4,3,75.49911,Cluster 3
1041,82,11,42,40,157.025,Cluster 3
1042,3,2,2,1,0.2661111,Cluster 3
1043,8,3,6,2,513.5468,Cluster 3
1045,57,18,30,27,702.749,Cluster 3
1046,82,15,41,41,70.563515,Cluster 3
1047,104,13,52,52,52.391552,Cluster 3
1050,31,6,19,12,530.28723,Cluster 3
1051,67,12,29,38,401.17242,Cluster 3
1052,34,10,17,17,133.3821,Cluster 3
1053,54,14,27,27,161.27731,Cluster 3
1057,94,18,48,46,256.8134,Cluster 3
1058,21,5,11,10,187.68237,Cluster 3
1060,54,14,47,7,705.0217,Cluster 3
1061,20,7,11,9,301.49323,Cluster 3
1062,9,7,7,2,54.854095,Cluster 3
1063,9,4,7,2,102.03421,Cluster 3
1065,8,4,6,2,31.895247,Cluster 3
1066,4,2,3,1,24.764862,Cluster 3
1067,183,7,137,46,88.669815,Cluster 3
1068,14,6,8,6,1086.467,Cluster 3
1070,26,6,14,12,434.86334,Cluster 3
1071,28,9,15,13,400.81244,Cluster 3
1073,34,7,21,13,140.79813,Cluster 3
1074,32,4,20,12,983.02905,Cluster 3
1075,130,6,100,30,166.20993,Cluster 3
1076,17,1,15,2,22.793007,Cluster 3
1077,42,10,27,15,364.34564,Cluster 3
1078,12,6,6,6,505.7327,Cluster 3
1079,14,4,7,7,65.33165,Cluster 3
1080,11,2,7,4,760.32904,Cluster 3
1081,11,4,6,5,319.2361,Cluster 3
1084,47,5,21,26,98.29205,Cluster 3
1085,52,5,26,26,86.92693,Cluster 3
1086,110,15,60,50,20.330896,Cluster 3
1087,3,2,2,1,0.97375,Cluster 3
1089,183,16,93,90,73.59845,Cluster 3
1091,125,19,63,62,72.9912,Cluster 3
1092,30,6,15,15,181.10712,Cluster 3
1093,21,3,11,10,62.904003,Cluster 3
1094,71,14,40,31,213.24178,Cluster 3
1095,4,1,2,2,155.05083,Cluster 3
1096,50,15,27,23,439.29565,Cluster 3
1097,147,41,74,73,228.74002,Cluster 3
1098,30,9,16,14,239.25206,Cluster 3
1099,131,24,92,39,170.62662,Cluster 3
1101,19,6,12,7,709.006,Cluster 3
1102,44,12,27,17,262.37408,Cluster 3
1103,378,30,204,174,232.19199,Cluster 3
1104,355,30,188,167,128.54996,Cluster 3
1106,14,8,9,5,91.04389,Cluster 3
1107,88,12,45,43,42.05283,Cluster 3
1108,112,24,64,48,273.6075,Cluster 3
1109,135,28,84,51,181.70583,Cluster 3
1112,14,2,8,6,193.89133,Cluster 3
1113,11,6,10,1,98.49499,Cluster 3
1116,35,6,17,18,516.6988,Cluster 3
1117,20,6,10,10,188.15068,Cluster 3
1118,10,3,7,3,523.4065,Cluster 3
1119,27,6,22,5,609.02423,Cluster 3
1120,3,2,2,1,0.04625,Cluster 3
1121,31,10,25,6,652.5594,Cluster 3
1122,26,8,14,12,70.71994,Cluster 3
1125,57,12,28,29,174.53764,Cluster 3
1128,119,28,66,53,23.577862,Cluster 3
1129,12,3,6,6,528.5144,Cluster 3
1130,76,13,39,37,36.98265,Cluster 3
1132,5,2,2,3,728.57764,Cluster 3
1134,38,9,21,17,282.76096,Cluster 3
1136,258,32,136,122,38.90011,Cluster 3
1137,10,3,6,4,382.5959,Cluster 3
1138,275,27,148,127,177.35968,Cluster 3
1139,45,7,25,20,73.995056,Cluster 3
1140,7,3,5,2,352.90582,Cluster 3
1145,44,5,23,21,78.25477,Cluster 3
1146,9,2,7,2,564.0808,Cluster 3
1147,16,2,9,7,462.539,Cluster 3
1150,18,7,9,9,101.800545,Cluster 3
1152,14,2,9,5,517.2084,Cluster 3
1153,41,16,24,17,435.3051,Cluster 3
1154,13,2,7,6,226.16292,Cluster 3
1155,57,18,31,26,288.78525,Cluster 3
1157,28,8,27,1,305.49515,Cluster 3
1158,6,3,4,2,41.972454,Cluster 3
1159,6,2,4,2,117.05007,Cluster 3
1160,72,5,37,35,86.19244,Cluster 3
1161,15,5,8,7,129.97104,Cluster 3
1162,39,8,20,19,516.0627,Cluster 3
1163,86,18,49,37,81.449974,Cluster 3
1164,134,19,96,38,357.7253,Cluster 3
1165,18,6,10,8,498.50043,Cluster 3
1166,19,5,11,8,532.378,Cluster 3
1167,46,2,24,22,138.88708,Cluster 3
1168,3,1,2,1,1047.7214,Cluster 3
1169,20,4,10,10,315.8035,Cluster 3
1171,48,10,46,2,1018.64655,Cluster 3
1172,4,2,3,1,0.07819445,Cluster 3
1173,10,5,6,4,972.7439,Cluster 3
1174,51,13,30,21,121.83165,Cluster 3
1175,7,5,5,2,485.88007,Cluster 3
1176,20,5,11,9,422.74084,Cluster 3
1177,122,17,63,59,218.59021,Cluster 3
1178,22,4,18,4,968.76697,Cluster 3
1179,7,2,4,3,799.86896,Cluster 3
1180,23,10,14,9,1044.4882,Cluster 3
1181,29,8,15,14,236.09152,Cluster 3
1182,34,13,21,13,250.81236,Cluster 3
1183,9,2,5,4,0.53879166,Cluster 3
1185,29,4,15,14,224.29349,Cluster 3
1188,166,32,103,63,255.92654,Cluster 3
1190,15,5,9,6,181.80191,Cluster 3
1191,30,15,20,10,14.728009,Cluster 3
1192,14,5,8,6,32.630833,Cluster 3
1194,27,9,15,12,641.55554,Cluster 3
1197,14,8,11,3,1002.25037,Cluster 3
1199,22,7,12,10,760.0093,Cluster 3
1200,25,12,15,10,15.538483,Cluster 3
1201,86,24,43,43,316.05737,Cluster 3
1202,6,4,4,2,179.02382,Cluster 3
1203,3,1,2,1,513.68054,Cluster 3
1204,12,4,7,5,655.5666,Cluster 3
1206,66,29,34,32,120.27755,Cluster 3
1208,6,2,3,3,1089.375,Cluster 3
1210,53,14,29,24,422.16528,Cluster 3
1211,22,1,11,11,159.2422,Cluster 3
1215,24,8,12,12,77.95714,Cluster 3
1216,24,7,13,11,312.30832,Cluster 3
1217,14,7,7,7,248.82175,Cluster 3
1218,20,3,10,10,283.99542,Cluster 3
1219,21,5,13,8,473.84924,Cluster 3
1220,15,8,8,7,387.44513,Cluster 3
1221,4,3,3,1,949.8711,Cluster 3
1222,91,18,47,44,260.54645,Cluster 3
1224,32,11,16,16,440.9124,Cluster 3
1226,28,7,18,10,103.317,Cluster 3
1227,150,16,85,65,496.85147,Cluster 3
1228,270,22,147,123,191.58165,Cluster 3
1229,20,6,10,10,90.3092,Cluster 3
1230,74,17,41,33,73.94371,Cluster 3
1231,123,29,66,57,125.94578,Cluster 3
1232,61,17,31,30,100.95725,Cluster 3
1233,37,14,20,17,195.41171,Cluster 3
1234,22,6,12,10,144.84877,Cluster 3
1235,52,16,27,25,183.16312,Cluster 3
1237,27,11,15,12,545.0411,Cluster 3
1238,18,6,9,9,98.40832,Cluster 3
1239,9,4,5,4,803.9897,Cluster 3
1240,20,5,12,8,169.03285,Cluster 3
1241,139,33,76,63,265.1748,Cluster 3
1244,90,17,48,42,311.50827,Cluster 3
1245,24,8,13,11,84.88169,Cluster 3
1246,4,2,3,1,56.0,Cluster 3
1247,5,3,4,1,207.37186,Cluster 3
1248,132,3,66,66,656.8682,Cluster 3
1250,82,11,78,4,533.3463,Cluster 3
1251,64,23,51,13,1066.4335,Cluster 3
1255,18,4,10,8,186.33957,Cluster 3
1256,13,3,7,6,582.7728,Cluster 3
1257,11,5,7,4,412.11633,Cluster 3
1258,3,2,2,1,0.09680556,Cluster 3
1259,4,2,2,2,82.96965,Cluster 3
1262,4,2,2,2,504.5,Cluster 3
1264,4,1,2,2,510.5789,Cluster 3
1265,33,12,20,13,41.63063,Cluster 3
1266,11,5,7,4,128.12854,Cluster 3
1267,102,18,51,51,118.62963,Cluster 3
1268,10,4,7,3,42.29073,Cluster 3
1269,13,3,8,5,38.823456,Cluster 3
1270,11,3,6,5,69.36449,Cluster 3
1271,9,5,5,4,677.965,Cluster 3
1272,22,3,11,11,64.4155,Cluster 3
1273,6,5,5,1,62.007915,Cluster 3
1274,137,31,70,67,195.67966,Cluster 3
1275,3,1,2,1,103.91037,Cluster 3
1276,16,7,8,8,484.8525,Cluster 3
1277,38,8,27,11,541.1387,Cluster 3
1278,3,1,2,1,392.41714,Cluster 3
1280,22,5,12,10,138.11859,Cluster 3
1282,8,4,4,4,356.755,Cluster 3
1283,105,11,58,47,152.064,Cluster 3
1284,7,3,4,3,5.51446,Cluster 3
1285,26,7,13,13,280.47205,Cluster 3
1287,35,11,19,16,144.44724,Cluster 3
1289,95,14,49,46,117.29083,Cluster 3
1290,20,8,11,9,767.01794,Cluster 3
1292,20,8,9,11,578.7081,Cluster 3
1293,39,11,22,17,66.49396,Cluster 3
1294,17,8,9,8,261.85913,Cluster 3
1295,29,9,26,3,328.75262,Cluster 3
1296,21,8,11,10,538.0095,Cluster 3
1297,41,6,24,17,530.9285,Cluster 3
1298,13,5,7,6,490.3499,Cluster 3
1299,10,2,5,5,319.55136,Cluster 3
1300,29,3,15,14,559.9488,Cluster 3
1301,16,6,10,6,153.36737,Cluster 3
1302,31,6,22,9,47.090225,Cluster 3
1303,56,2,28,28,109.394325,Cluster 3
1304,10,8,9,1,42.457985,Cluster 3
1305,205,14,104,101,42.420216,Cluster 3
1306,211,21,105,106,37.19838,Cluster 3
1307,30,9,15,15,188.99426,Cluster 3
1309,13,4,7,6,310.2316,Cluster 3
1310,21,9,11,10,267.44824,Cluster 3
1311,69,22,35,34,131.1097,Cluster 3
1312,50,9,26,24,171.40056,Cluster 3
1313,7,3,4,3,213.67508,Cluster 3
1314,8,2,4,4,725.7933,Cluster 3
1316,4,2,2,2,720.25006,Cluster 3
1318,32,6,16,16,267.40253,Cluster 3
1320,14,5,8,6,500.05627,Cluster 3
1321,11,5,7,4,370.63324,Cluster 3
1323,324,28,154,170,91.81793,Cluster 3
1324,139,34,79,60,285.08362,Cluster 3
1325,17,4,9,8,301.81805,Cluster 3
1326,186,28,105,81,200.28831,Cluster 3
1327,30,8,18,12,117.15296,Cluster 3
1328,5,2,3,2,690.679,Cluster 3
1330,19,7,11,8,758.5115,Cluster 3
1331,44,20,23,21,989.8363,Cluster 3
1332,13,4,8,5,210.17995,Cluster 3
1333,264,38,132,132,46.203793,Cluster 3
1334,7,2,5,2,265.35294,Cluster 3
1335,19,6,12,7,80.253815,Cluster 3
1336,23,7,14,9,801.6805,Cluster 3
1337,23,6,12,11,809.8356,Cluster 3
1338,12,4,7,5,677.83356,Cluster 3
1339,10,4,6,4,79.855156,Cluster 3
1341,28,9,16,12,454.50888,Cluster 3
1343,49,15,43,6,680.9409,Cluster 3
1345,37,8,25,12,70.57876,Cluster 3
1346,104,3,89,15,75.50796,Cluster 3
1348,5,1,3,2,835.2609,Cluster 3
1349,81,16,39,42,266.4644,Cluster 3
1350,5,3,3,2,17.974792,Cluster 3
1351,7,3,5,2,672.8984,Cluster 3
1352,7,3,4,3,12.148349,Cluster 3
1353,54,5,29,25,312.2648,Cluster 3
1355,45,18,23,22,216.53705,Cluster 3
1356,13,4,7,6,84.58722,Cluster 3
1359,39,14,19,20,212.48247,Cluster 3
1360,24,10,13,11,296.5356,Cluster 3
1361,16,6,8,8,748.28644,Cluster 3
1362,18,8,9,9,424.79184,Cluster 3
1365,2,1,1,1,168.68973,Cluster 3
1366,418,16,211,207,45.53409,Cluster 3
1367,31,3,28,3,157.177,Cluster 3
1368,131,21,69,62,165.64442,Cluster 3
1369,66,18,37,29,162.7577,Cluster 3
1370,4,2,3,1,0.7441667,Cluster 3
1371,133,11,86,47,153.97327,Cluster 3
1372,34,11,22,12,247.00433,Cluster 3
1373,22,5,12,10,319.5874,Cluster 3
1374,5,2,3,2,1051.29,Cluster 3
1375,64,16,39,25,483.37262,Cluster 3
1376,25,5,19,6,50.517735,Cluster 3
1377,7,5,6,1,0.22888888,Cluster 3
1380,11,7,7,4,693.3333,Cluster 3
1381,22,7,12,10,661.81946,Cluster 3
1383,84,17,59,25,563.52313,Cluster 3
1384,103,15,55,48,169.1811,Cluster 3
1385,3,2,2,1,0.6755555,Cluster 3
1386,145,15,73,72,25.59919,Cluster 3
1387,48,10,25,23,414.77017,Cluster 3
1388,17,4,15,2,969.77356,Cluster 3
1390,3,2,2,1,34.750973,Cluster 3
1391,33,14,17,16,255.22662,Cluster 3
1392,9,2,5,4,134.63199,Cluster 3
1395,23,7,14,9,114.19149,Cluster 3
1398,354,23,184,170,222.59244,Cluster 3
1399,52,14,26,26,454.31186,Cluster 3
1400,7,4,4,3,2.4189816,Cluster 3
1401,35,11,18,17,155.19487,Cluster 3
1402,10,4,5,5,562.9292,Cluster 3
1404,37,7,19,18,88.91451,Cluster 3
1405,29,15,15,14,175.85902,Cluster 3
1406,40,10,25,15,302.25272,Cluster 3
1407,17,8,9,8,328.09372,Cluster 3
1410,4,1,2,2,623.80194,Cluster 3
1411,370,17,183,187,351.64853,Cluster 3
1413,11,5,9,2,712.12494,Cluster 3
1415,25,7,15,10,476.2313,Cluster 3
1416,57,13,45,12,422.3789,Cluster 3
1418,18,6,9,9,5.8930864,Cluster 3
1420,30,6,25,5,1119.1781,Cluster 3
1421,22,8,16,6,0.2345679,Cluster 3
1422,6,4,4,2,576.481,Cluster 3
1424,25,4,14,11,377.9844,Cluster 3
1425,30,13,17,13,534.74835,Cluster 3
1426,23,5,14,9,213.27017,Cluster 3
1427,84,13,61,23,376.73428,Cluster 3
1429,17,4,9,8,22.061787,Cluster 3
1431,2,1,1,1,0.4861111,Cluster 3
1432,35,4,32,3,593.43207,Cluster 3
1433,68,11,32,36,87.977104,Cluster 3
1434,23,9,14,9,496.0991,Cluster 3
1437,31,9,20,11,122.00798,Cluster 3
1438,3,1,2,1,312.33325,Cluster 3
1439,8,4,5,3,639.4382,Cluster 3
1440,37,13,19,18,565.20465,Cluster 3
1443,78,10,44,34,85.803665,Cluster 3
1444,16,6,12,4,450.01425,Cluster 3
1445,559,19,368,191,26.758455,Cluster 3
1447,55,16,28,27,374.0277,Cluster 3
1448,5,3,3,2,1.0924306,Cluster 3
1449,220,15,180,40,59.23811,Cluster 3
1451,21,4,13,8,209.65233,Cluster 3
1452,14,4,7,7,147.4826,Cluster 3
1453,12,4,7,5,61.04958,Cluster 3
1454,17,4,10,7,100.494774,Cluster 3
1455,9,5,5,4,458.89136,Cluster 3
1457,6,3,5,1,0.037638888,Cluster 3
1458,10,2,5,5,64.864586,Cluster 3
1460,6,3,3,3,1.7794907,Cluster 3
1461,22,7,11,11,340.1501,Cluster 3
1462,15,6,8,7,398.14197,Cluster 3
1463,21,7,12,9,27.244312,Cluster 3
1464,23,6,13,10,230.21436,Cluster 3
1465,12,8,8,4,999.4744,Cluster 3
1466,87,30,44,43,20.621534,Cluster 3
1467,39,8,27,12,486.3631,Cluster 3
1469,33,15,20,13,368.4274,Cluster 3
1471,14,7,7,7,630.7493,Cluster 3
1472,28,13,14,14,121.84721,Cluster 3
1475,27,9,14,13,62.21589,Cluster 3
1476,22,4,12,10,330.55548,Cluster 3
1477,17,9,9,8,108.52892,Cluster 3
1478,18,3,11,7,1083.1592,Cluster 3
1480,63,7,46,17,112.97707,Cluster 3
1481,90,25,74,16,511.06152,Cluster 3
1484,4,2,2,2,534.76263,Cluster 3
1485,44,5,28,16,107.61743,Cluster 3
1486,2,1,1,1,577.1665,Cluster 3
1487,4,2,2,2,168.33264,Cluster 3
1488,15,5,8,7,8.755722,Cluster 3
1491,29,5,16,13,413.51782,Cluster 3
1493,6,3,4,2,109.9041,Cluster 3
1494,24,9,12,12,596.58234,Cluster 3
1495,99,20,51,48,127.38201,Cluster 3
1496,162,18,82,80,208.80089,Cluster 3
1498,30,7,20,10,727.47845,Cluster 3
1499,19,3,9,10,442.57123,Cluster 3
1500,23,7,12,11,602.28406,Cluster 3
1502,49,14,33,16,832.9255,Cluster 3
1503,13,3,7,6,301.0687,Cluster 3
1505,17,7,9,8,2.3268533,Cluster 3
1506,497,23,255,242,96.183685,Cluster 3
1507,26,6,13,13,288.49518,Cluster 3
1508,28,8,20,8,675.9895,Cluster 3
1509,15,6,8,7,283.18362,Cluster 3
1510,78,23,39,39,856.9281,Cluster 3
1511,4,2,2,2,870.5978,Cluster 3
1512,60,14,31,29,159.6455,Cluster 3
1513,34,12,17,17,364.42297,Cluster 3
1515,47,5,25,22,70.78827,Cluster 3
1516,39,12,21,18,375.90137,Cluster 3
1519,129,1,65,64,34.587532,Cluster 3
1520,21,5,10,11,556.92053,Cluster 3
1521,79,24,41,38,147.64264,Cluster 3
1522,24,10,12,12,64.3849,Cluster 3
1524,66,9,56,10,535.0063,Cluster 3
1525,32,6,16,16,449.58194,Cluster 3
1526,34,9,18,16,302.94025,Cluster 3
1527,70,16,43,27,152.03859,Cluster 3
1528,9,4,5,4,576.9996,Cluster 3
1529,17,8,11,6,596.8718,Cluster 3
1530,45,17,23,22,336.94952,Cluster 3
1531,135,20,86,49,85.29915,Cluster 3
1533,47,10,37,10,411.5953,Cluster 3
1535,13,5,7,6,276.26456,Cluster 3
1536,15,6,9,6,51.07227,Cluster 3
1537,5,2,3,2,466.49286,Cluster 3
1538,7,4,4,3,436.05603,Cluster 3
1540,10,5,7,3,400.3251,Cluster 3
1541,25,8,15,10,92.02688,Cluster 3
1542,15,6,9,6,763.26685,Cluster 3
1543,377,35,199,178,15.04528,Cluster 3
1544,7,4,6,1,0.14152777,Cluster 3
1545,22,2,13,9,310.27646,Cluster 3
1546,73,17,35,38,58.62101,Cluster 3
1547,19,8,10,9,502.90775,Cluster 3
1550,11,4,7,4,294.44,Cluster 3
1551,6,3,4,2,6.228125,Cluster 3
1552,5,2,3,2,4.5588193,Cluster 3
1553,11,4,6,5,73.29525,Cluster 3
1554,111,20,79,32,281.19254,Cluster 3
1556,6,3,3,3,443.32864,Cluster 3
1558,129,19,72,57,129.65616,Cluster 3
1559,29,8,15,14,136.33707,Cluster 3
1560,5,3,4,1,6.499514,Cluster 3
1561,5,3,3,2,348.91895,Cluster 3
1562,414,23,309,105,112.975845,Cluster 3
1563,15,4,14,1,423.51373,Cluster 3
1564,12,4,8,4,996.3333,Cluster 3
1565,10,5,5,5,583.2079,Cluster 3
1566,40,12,21,19,74.33764,Cluster 3
1567,77,13,39,38,262.86905,Cluster 3
1568,6,3,3,3,3.9921296,Cluster 3
1569,34,10,19,15,420.04974,Cluster 3
1570,6,3,3,3,240.81949,Cluster 3
1571,46,12,26,20,284.68478,Cluster 3
1572,26,6,22,4,663.7633,Cluster 3
1574,37,8,19,18,248.14055,Cluster 3
1576,18,7,9,9,615.8971,Cluster 3
1577,70,22,41,29,474.2239,Cluster 3
1579,13,3,9,4,50.951305,Cluster 3
1580,3,1,2,1,136.3925,Cluster 3
1581,17,3,9,8,48.766644,Cluster 3
1582,36,13,19,17,194.33788,Cluster 3
1583,17,6,11,6,237.00403,Cluster 3
1584,115,12,81,34,201.90755,Cluster 3
1587,135,22,78,57,164.74472,Cluster 3
1588,3,1,2,1,288.00018,Cluster 3
1589,364,23,234,130,238.63263,Cluster 3
1590,17,5,11,6,173.2957,Cluster 3
1591,34,12,19,15,461.59976,Cluster 3
1592,18,9,10,8,542.6564,Cluster 3
1593,38,6,27,11,320.2734,Cluster 3
1594,37,14,20,17,100.35148,Cluster 3
1595,84,20,40,44,344.16965,Cluster 3
1596,7,2,4,3,233.96706,Cluster 3
1597,48,7,25,23,142.03639,Cluster 3
1598,12,4,7,5,188.52003,Cluster 3
1599,10,2,6,4,172.95758,Cluster 3
1600,19,9,10,9,174.14394,Cluster 3
1601,9,3,5,4,567.5741,Cluster 3
1602,4,2,3,1,128.10648,Cluster 3
1604,9,6,8,1,258.90085,Cluster 3
1605,165,13,89,76,218.10098,Cluster 3
1606,4,2,3,1,56.333332,Cluster 3
1609,7,5,5,2,497.015,Cluster 3
1611,23,5,14,9,669.92377,Cluster 3
1612,399,29,200,199,166.20232,Cluster 3
1613,9,2,8,1,521.21735,Cluster 3
1614,25,6,14,11,562.7624,Cluster 3
1616,27,5,16,11,120.07227,Cluster 3
1617,12,4,9,3,631.39453,Cluster 3
1618,10,3,5,5,712.1665,Cluster 3
1619,278,27,169,109,159.30324,Cluster 3
1621,104,11,78,26,226.54147,Cluster 3
1622,103,12,51,52,215.13928,Cluster 3
1623,21,7,11,10,139.36136,Cluster 3
1624,218,10,168,50,135.83237,Cluster 3
1625,5,3,3,2,455.5341,Cluster 3
1626,337,27,176,161,90.6215,Cluster 3
1627,33,5,18,15,460.65494,Cluster 3
1628,78,16,46,32,36.627834,Cluster 3
1630,29,5,27,2,362.18076,Cluster 3
1631,5,2,3,2,349.99994,Cluster 3
1634,37,6,31,6,738.0915,Cluster 3
1635,6,4,4,2,503.2856,Cluster 3
1636,32,4,19,13,298.6861,Cluster 3
1637,3,1,2,1,471.9999,Cluster 3
1638,10,4,5,5,627.2658,Cluster 3
1640,53,6,38,15,140.8156,Cluster 3
1641,72,19,36,36,120.30501,Cluster 3
1642,22,4,14,8,197.50618,Cluster 3
1644,4,2,2,2,731.3376,Cluster 3
1647,332,15,240,92,101.0467,Cluster 3
1649,35,18,18,17,187.6361,Cluster 3
1651,53,6,51,2,303.39948,Cluster 3
1652,8,2,4,4,563.94635,Cluster 3
1654,26,5,13,13,8.040449,Cluster 3
1655,36,7,22,14,510.39624,Cluster 3
1656,363,10,358,5,119.09688,Cluster 3
1657,38,4,19,19,100.416245,Cluster 3
1659,28,7,16,12,441.1683,Cluster 3
1661,9,4,5,4,219.51291,Cluster 3
1662,2,1,1,1,0.47194445,Cluster 3
1663,41,5,37,4,324.0727,Cluster 3
1665,94,12,48,46,168.99133,Cluster 3
1666,6,2,4,2,297.1421,Cluster 3
1667,9,5,5,4,193.86743,Cluster 3
1668,6,3,5,1,0.011898148,Cluster 3
1669,8,5,5,3,968.29016,Cluster 3
1670,19,4,15,4,964.3347,Cluster 3
1671,40,13,33,7,1074.88,Cluster 3
1672,19,3,10,9,326.7778,Cluster 3
1673,62,17,34,28,221.14311,Cluster 3
1674,13,5,7,6,306.93274,Cluster 3
1675,17,8,9,8,375.25128,Cluster 3
1677,20,10,10,10,81.84964,Cluster 3
1679,14,7,8,6,538.5803,Cluster 3
1680,146,26,92,54,268.51074,Cluster 3
1681,11,4,7,4,60.505775,Cluster 3
1682,4,1,3,1,203.74646,Cluster 3
1683,37,13,21,16,284.81778,Cluster 3
1685,20,8,11,9,0.42391536,Cluster 3
1686,67,11,51,16,308.4991,Cluster 3
1687,19,6,10,9,426.08136,Cluster 3
1688,10,5,9,1,1053.3419,Cluster 3
1689,36,14,18,18,146.23183,Cluster 3
1690,19,5,11,8,166.61436,Cluster 3
1691,5,4,4,1,0.31819445,Cluster 3
1692,120,10,61,59,87.587166,Cluster 3
1693,48,14,24,24,359.28125,Cluster 3
1694,16,7,9,7,179.0521,Cluster 3
1695,7,2,5,2,52.09293,Cluster 3
1696,75,10,41,34,188.1712,Cluster 3
1697,7,3,4,3,114.0529,Cluster 3
1698,25,9,13,12,364.76822,Cluster 3
1699,33,8,25,8,912.8401,Cluster 3
1700,7,3,4,3,244.65236,Cluster 3
1701,38,13,24,14,769.4527,Cluster 3
1702,69,18,38,31,127.19874,Cluster 3
1703,13,4,6,7,837.3988,Cluster 3
1704,7,3,4,3,221.40529,Cluster 3
1705,35,14,18,17,419.37006,Cluster 3
1706,72,10,39,33,74.45355,Cluster 3
1707,18,8,10,8,88.68027,Cluster 3
1708,2,1,1,1,0.45972222,Cluster 3
1709,6,1,3,3,31.836805,Cluster 3
1710,185,33,99,86,335.434,Cluster 3
1712,113,33,57,56,267.62537,Cluster 3
1714,59,13,33,26,187.26993,Cluster 3
1715,10,4,5,5,129.57486,Cluster 3
1716,36,12,20,16,261.0262,Cluster 3
1717,85,27,50,35,281.50513,Cluster 3
1718,15,7,8,7,917.7079,Cluster 3
1719,35,15,19,16,318.95477,Cluster 3
1720,111,14,65,46,152.73563,Cluster 3
1721,16,5,10,6,60.026905,Cluster 3
1723,218,14,113,105,57.091183,Cluster 3
1724,82,8,50,32,385.03754,Cluster 3
1725,35,5,21,14,211.57088,Cluster 3
1726,6,2,4,2,203.73566,Cluster 3
1728,2,1,1,1,610.9021,Cluster 3
1729,19,7,11,8,216.75296,Cluster 3
1730,177,26,97,80,247.4983,Cluster 3
1731,2,1,1,1,23.9775,Cluster 3
1732,65,7,37,28,22.689915,Cluster 3
1736,199,36,102,97,112.82345,Cluster 3
1737,2,1,1,1,1044.0886,Cluster 3
1739,59,15,30,29,6.3839126,Cluster 3
1740,58,14,36,22,485.9634,Cluster 3
1742,109,14,55,54,69.527855,Cluster 3
1745,5,3,3,2,982.1326,Cluster 3
1746,245,14,172,73,255.64232,Cluster 3
1747,13,2,7,6,258.4483,Cluster 3
1748,4,3,3,1,0.3036111,Cluster 3
1750,24,6,12,12,185.3503,Cluster 3
1751,59,23,29,30,586.5629,Cluster 3
1752,65,9,55,10,213.68286,Cluster 3
1753,20,7,11,9,707.203,Cluster 3
1754,17,5,11,6,677.033,Cluster 3
1756,9,3,5,4,406.64465,Cluster 3
1757,7,4,6,1,264.33875,Cluster 3
1759,59,15,30,29,176.98538,Cluster 3
1761,16,6,9,7,590.82275,Cluster 3
1762,84,24,45,39,181.81667,Cluster 3
1763,41,9,21,20,152.71683,Cluster 3
1764,12,6,7,5,862.24664,Cluster 3
1765,2,1,1,1,935.14526,Cluster 3
1766,203,43,118,85,58.257755,Cluster 3
1767,62,7,44,18,147.54105,Cluster 3
1768,7,4,4,3,619.9575,Cluster 3
1769,19,5,11,8,160.16795,Cluster 3
1770,127,11,91,36,280.51883,Cluster 3
1771,107,31,56,51,332.67575,Cluster 3
1774,26,4,21,5,618.54395,Cluster 3
1776,84,19,42,42,85.16277,Cluster 3
1777,7,3,4,3,369.0417,Cluster 3
1778,3,2,2,1,37.990696,Cluster 3
1780,119,20,62,57,41.401474,Cluster 3
1781,10,2,9,1,384.08636,Cluster 3
1782,3,2,2,1,0.1723611,Cluster 3
1783,33,14,17,16,343.61713,Cluster 3
1785,13,1,11,2,273.15384,Cluster 3
1788,29,10,22,7,666.72974,Cluster 3
1790,27,6,21,6,618.4532,Cluster 3
1791,21,4,13,8,11.60845,Cluster 3
1793,85,24,45,40,59.287956,Cluster 3
1795,46,10,23,23,537.43054,Cluster 3
1796,31,9,17,14,125.61182,Cluster 3
1797,20,9,11,9,999.22723,Cluster 3
1799,35,6,30,5,359.33466,Cluster 3
1800,34,10,19,15,261.23566,Cluster 3
1802,22,7,12,10,287.2527,Cluster 3
1805,4,2,2,2,0.92125,Cluster 3
1806,86,10,72,14,143.99884,Cluster 3
1808,39,9,20,19,397.86353,Cluster 3
1809,2,1,1,1,0.02486111,Cluster 3
1810,15,7,8,7,6.33375,Cluster 3
1811,26,13,14,12,161.82622,Cluster 3
1812,56,13,31,25,272.26718,Cluster 3
1813,77,4,39,38,21.777061,Cluster 3
1814,46,4,20,26,109.9615,Cluster 3
1815,6,2,3,3,0.05659722,Cluster 3
1816,451,24,239,212,75.60895,Cluster 3
1817,10,1,6,4,12.225194,Cluster 3
1818,105,21,53,52,117.588646,Cluster 3
1819,106,21,54,52,85.02255,Cluster 3
1820,74,21,39,35,435.92676,Cluster 3
1821,71,14,65,6,729.7478,Cluster 3
1822,54,19,32,22,213.9605,Cluster 3
1824,31,11,16,15,384.05557,Cluster 3
1826,200,43,100,100,300.3465,Cluster 3
1829,171,24,88,83,42.834534,Cluster 3
1830,55,13,28,27,115.731415,Cluster 3
1831,4,1,2,2,0.38215277,Cluster 3
1832,39,12,20,19,34.788315,Cluster 3
1833,160,27,98,62,271.60596,Cluster 3
1834,4,2,2,2,401.89743,Cluster 3
1835,123,29,66,57,122.01203,Cluster 3
1837,27,12,16,11,631.559,Cluster 3
1840,161,18,102,59,69.33565,Cluster 3
1841,22,4,13,9,505.54507,Cluster 3
1843,42,11,22,20,101.472336,Cluster 3
1844,44,3,24,20,121.301704,Cluster 3
1845,34,11,24,10,299.43008,Cluster 3
1846,68,19,35,33,176.59279,Cluster 3
1847,104,25,96,8,769.8653,Cluster 3
1848,201,19,141,60,112.42801,Cluster 3
1849,130,20,73,57,238.33606,Cluster 3
1850,45,13,28,17,277.7056,Cluster 3
1851,38,7,20,18,339.9813,Cluster 3
1853,53,10,29,24,67.32862,Cluster 3
1854,158,20,81,77,10.832271,Cluster 3
1856,35,7,18,17,6.4514823,Cluster 3
1857,211,24,138,73,247.47238,Cluster 3
1858,10,5,5,5,700.44366,Cluster 3
1859,355,14,189,166,79.6651,Cluster 3
1861,25,5,18,7,86.59658,Cluster 3
1862,61,10,35,26,207.17024,Cluster 3
1863,5,3,3,2,1073.2925,Cluster 3
1864,15,8,10,5,746.0008,Cluster 3
1865,35,9,16,19,412.32983,Cluster 3
1866,173,24,91,82,77.921936,Cluster 3
1867,31,17,18,13,1042.7308,Cluster 3
1868,9,4,6,3,228.5964,Cluster 3
1869,57,13,29,28,98.642746,Cluster 3
1870,15,7,11,4,105.41833,Cluster 3
1871,5,3,3,2,137.95847,Cluster 3
1872,14,4,9,5,256.57196,Cluster 3
1873,28,14,16,12,243.1513,Cluster 3
1874,40,7,32,8,234.02802,Cluster 3
1875,324,31,194,130,60.561634,Cluster 3
1876,14,5,8,6,19.198288,Cluster 3
1877,24,9,14,10,254.56758,Cluster 3
1878,18,7,10,8,315.65048,Cluster 3
1880,23,4,12,11,356.74518,Cluster 3
1881,15,3,9,6,581.69165,Cluster 3
1882,70,11,36,34,158.32207,Cluster 3
1883,35,9,24,11,341.644,Cluster 3
1884,18,6,9,9,86.72017,Cluster 3
1885,133,30,66,67,142.07066,Cluster 3
1886,4,1,2,2,29.165764,Cluster 3
1887,34,10,21,13,32.936344,Cluster 3
1888,11,6,6,5,741.294,Cluster 3
1890,15,5,8,7,224.25317,Cluster 3
1891,48,11,26,22,17.084042,Cluster 3
1892,26,6,19,7,359.11725,Cluster 3
1894,36,14,23,13,431.72733,Cluster 3
1895,10,5,6,4,276.4599,Cluster 3
1896,415,20,210,205,42.29737,Cluster 3
1897,173,34,88,85,98.647644,Cluster 3
1898,4,2,2,2,0.39152777,Cluster 3
1899,39,15,22,17,162.93332,Cluster 3
1900,5,3,4,1,0.08444444,Cluster 3
1901,21,5,13,8,117.510994,Cluster 3
1902,13,5,8,5,398.36237,Cluster 3
1904,3,1,2,1,288.0001,Cluster 3
1906,9,6,7,2,568.00006,Cluster 3
1907,3,2,2,1,348.145,Cluster 3
1908,11,4,6,5,488.93085,Cluster 3
1909,204,21,112,92,88.80848,Cluster 3
1910,10,6,6,4,3.1024654,Cluster 3
1912,4,2,3,1,0.083680555,Cluster 3
1913,230,20,117,113,19.913918,Cluster 3
1914,55,5,47,8,178.69022,Cluster 3
1915,14,5,7,7,108.46243,Cluster 3
1916,4,2,2,2,335.4241,Cluster 3
1917,24,8,12,12,202.5899,Cluster 3
1919,72,8,36,36,65.860725,Cluster 3
1920,31,13,17,14,203.4397,Cluster 3
1921,20,5,10,10,216.41457,Cluster 3
1922,41,15,26,15,403.9932,Cluster 3
1923,17,7,9,8,279.76144,Cluster 3
1924,37,7,22,15,22.95848,Cluster 3
1926,19,8,11,8,6.841065,Cluster 3
1927,42,6,23,19,10.568007,Cluster 3
1928,40,7,22,18,361.63828,Cluster 3
1929,21,10,11,10,198.56789,Cluster 3
1931,46,6,23,23,87.04886,Cluster 3
1933,14,5,12,2,362.92313,Cluster 3
1934,44,7,26,18,167.576,Cluster 3
1935,161,34,83,78,40.201603,Cluster 3
1936,457,23,238,219,77.50304,Cluster 3
1937,15,6,8,7,78.74827,Cluster 3
1938,74,16,42,32,126.06383,Cluster 3
1939,136,20,84,52,76.15038,Cluster 3
1941,170,9,92,78,9.268174,Cluster 3
1942,10,4,5,5,54.505783,Cluster 3
1943,48,33,39,9,509.65,Cluster 3
1945,7,1,6,1,575.85724,Cluster 3
1948,5,3,4,1,857.9915,Cluster 3
1949,8,4,5,3,492.72366,Cluster 3
1951,288,13,149,139,13.237012,Cluster 3
1953,3,2,2,1,48.52486,Cluster 3
1954,271,34,139,132,165.44943,Cluster 3
1955,14,6,7,7,89.02896,Cluster 3
1956,83,14,43,40,184.12859,Cluster 3
1957,23,7,12,11,285.18332,Cluster 3
1958,45,9,23,22,134.57751,Cluster 3
1959,25,9,12,13,156.77237,Cluster 3
1960,23,9,12,11,522.1586,Cluster 3
1962,4,1,2,2,575.66174,Cluster 3
1963,33,11,18,15,133.47246,Cluster 3
1964,6,3,3,3,776.9278,Cluster 3
1966,4,2,2,2,829.18994,Cluster 3
1968,18,7,10,8,99.09962,Cluster 3
1970,9,3,5,4,456.90952,Cluster 3
1971,4,2,2,2,107.890625,Cluster 3
1972,12,8,8,4,118.113266,Cluster 3
1973,11,4,10,1,693.2164,Cluster 3
1974,25,2,13,12,140.86118,Cluster 3
1975,7,3,3,4,96.13355,Cluster 3
1976,16,6,10,6,133.63896,Cluster 3
1977,33,15,17,16,37.051865,Cluster 3
1979,9,5,5,4,357.90955,Cluster 3
1980,8,4,4,4,15.369306,Cluster 3
1981,64,14,35,29,280.63684,Cluster 3
1982,23,12,12,11,110.02175,Cluster 3
1983,17,6,9,8,231.62242,Cluster 3
1986,48,13,24,24,149.99323,Cluster 3
1987,6,3,3,3,124.24398,Cluster 3
1988,38,13,23,15,206.15863,Cluster 3
1989,11,3,6,5,244.62387,Cluster 3
1990,8,5,6,2,331.80154,Cluster 3
1991,28,4,15,13,214.85707,Cluster 3
1992,12,4,7,5,204.85036,Cluster 3
1994,15,5,9,6,309.65225,Cluster 3
1995,187,18,94,93,90.82887,Cluster 3
1996,10,2,6,4,389.68027,Cluster 3
1998,23,8,13,10,52.15188,Cluster 3
2000,11,3,6,5,123.610634,Cluster 3
2003,6,3,3,3,189.9405,Cluster 3
2004,9,5,6,3,471.36713,Cluster 3
2005,14,7,8,6,19.914822,Cluster 3
2006,161,15,80,81,112.72069,Cluster 3
2007,3,2,2,1,251.99986,Cluster 3
2008,79,12,40,39,272.90848,Cluster 3
2009,471,28,239,232,24.440935,Cluster 3
2010,10,3,6,4,27.851439,Cluster 3
2011,14,5,7,7,37.168945,Cluster 3
2012,53,10,39,14,77.11812,Cluster 3
2013,36,9,19,17,20.617708,Cluster 3
2014,39,9,23,16,147.38731,Cluster 3
2015,44,9,23,21,78.419975,Cluster 3
2016,18,8,16,2,235.6202,Cluster 3
2017,26,10,15,11,420.6903,Cluster 3
2018,16,5,8,8,67.05451,Cluster 3
2019,30,11,17,13,302.9583,Cluster 3
2020,3,2,2,1,275.99985,Cluster 3
2021,45,18,24,21,149.09117,Cluster 3
2022,59,15,42,17,396.41562,Cluster 3
2023,127,29,66,61,42.880836,Cluster 3
2024,52,6,44,8,192.05228,Cluster 3
2025,40,6,21,19,139.83961,Cluster 3
2028,183,26,97,86,153.03734,Cluster 3
2030,9,2,5,4,85.1717,Cluster 3
2031,236,22,141,95,62.803947,Cluster 3
2032,4,2,3,1,686.64417,Cluster 3
2034,58,10,34,24,131.66264,Cluster 3
2035,54,12,33,21,153.54398,Cluster 3
2036,10,4,6,4,0.17310186,Cluster 3
2038,10,4,6,4,480.545,Cluster 3
2039,90,13,47,43,134.25146,Cluster 3
2041,18,7,10,8,369.63995,Cluster 3
2043,156,47,80,76,80.48072,Cluster 3
2044,41,10,24,17,141.93237,Cluster 3
2046,20,9,10,10,26.214914,Cluster 3
2048,3,1,2,1,38.95139,Cluster 3
2049,12,5,8,4,280.03482,Cluster 3
2050,17,8,9,8,96.19403,Cluster 3
2051,45,8,24,21,160.06819,Cluster 3
2052,29,7,18,11,65.152435,Cluster 3
2053,12,5,6,6,298.945,Cluster 3
2054,17,5,12,5,94.24358,Cluster 3
2056,54,10,32,22,197.94789,Cluster 3
2059,10,3,8,2,1096.3439,Cluster 3
2060,120,29,60,60,80.03468,Cluster 3
2061,21,8,13,8,149.48535,Cluster 3
2062,16,11,13,3,212.20331,Cluster 3
2063,26,6,19,7,630.54047,Cluster 3
2065,132,19,67,65,47.689953,Cluster 3
2066,38,13,20,18,27.963747,Cluster 3
2067,4,2,2,2,311.5766,Cluster 3
2068,11,2,7,4,105.32012,Cluster 3
2070,5,2,4,1,1020.6369,Cluster 3
2071,8,4,4,4,75.57524,Cluster 3
2072,10,3,6,4,289.39188,Cluster 3
2073,36,9,19,17,143.51183,Cluster 3
2075,5,3,3,2,252.0,Cluster 3
2076,11,3,6,5,441.45636,Cluster 3
2078,27,12,15,12,545.1191,Cluster 3
2079,20,6,14,6,181.2975,Cluster 3
2080,69,19,33,36,67.09606,Cluster 3
2081,319,35,185,134,94.4837,Cluster 3
2082,2,1,1,1,347.94055,Cluster 3
2083,15,7,8,7,427.80234,Cluster 3
2084,26,11,14,12,211.84819,Cluster 3
2085,3,2,2,1,612.175,Cluster 3
2086,6,2,3,3,101.78604,Cluster 3
2088,9,4,5,4,126.017914,Cluster 3
2089,155,21,79,76,97.869385,Cluster 3
2090,23,9,12,11,164.7703,Cluster 3
2091,3,1,2,1,40.33852,Cluster 3
2092,8,5,6,2,4.1214585,Cluster 3
2093,187,10,95,92,15.425388,Cluster 3
2094,15,5,9,6,149.76515,Cluster 3
2095,207,19,145,62,63.231323,Cluster 3
2097,17,3,10,7,443.60516,Cluster 3
2098,12,6,8,4,0.12814815,Cluster 3
2099,4,1,2,2,210.00008,Cluster 3
2100,12,4,8,4,489.9683,Cluster 3
2101,13,6,7,6,416.28223,Cluster 3
2102,3,1,2,1,41.954445,Cluster 3
2103,9,4,7,2,353.80948,Cluster 3
2104,5,3,3,2,731.75006,Cluster 3
2106,8,5,6,2,84.97799,Cluster 3
2108,7,3,4,3,128.9229,Cluster 3
2110,28,11,15,13,51.253025,Cluster 3
2111,96,13,50,46,110.51628,Cluster 3
2112,32,10,16,16,47.581997,Cluster 3
2113,13,4,8,5,107.3184,Cluster 3
2114,10,1,4,6,225.68878,Cluster 3
2116,168,22,90,78,115.82232,Cluster 3
2117,9,3,5,4,113.0538,Cluster 3
2120,16,9,9,7,50.18008,Cluster 3
2121,2,1,1,1,12.0,Cluster 3
2122,44,11,22,22,4.942262,Cluster 3
2125,4,2,3,1,0.7156944,Cluster 3
2126,16,6,8,8,230.27478,Cluster 3
2127,53,20,27,26,141.36758,Cluster 3
2128,172,17,89,83,70.6913,Cluster 3
2129,95,10,58,37,36.784916,Cluster 3
2130,77,27,71,6,259.15683,Cluster 3
2131,29,6,25,4,367.7628,Cluster 3
2132,14,3,11,3,349.04352,Cluster 3
2133,281,35,157,124,41.88231,Cluster 3
2135,33,13,21,12,239.77003,Cluster 3
2137,56,6,51,5,169.94124,Cluster 3
2138,20,7,11,9,151.6616,Cluster 3
2140,40,3,19,21,143.81816,Cluster 3
2141,15,3,11,4,369.7716,Cluster 3
2142,26,6,18,8,402.40137,Cluster 3
2143,13,7,8,5,180.18723,Cluster 3
2144,43,6,27,16,377.2571,Cluster 3
2145,9,4,5,4,414.3408,Cluster 3
2146,108,10,64,44,90.76904,Cluster 3
2147,3,1,2,1,191.91185,Cluster 3
2148,60,10,36,24,257.69122,Cluster 3
2149,16,4,8,8,248.28752,Cluster 3
2150,8,5,6,2,285.5589,Cluster 3
2152,45,14,25,20,62.342384,Cluster 3
2153,37,27,31,6,409.09195,Cluster 3
2154,14,6,8,6,349.1211,Cluster 3
2155,10,4,6,4,71.02962,Cluster 3
2156,10,4,6,4,297.7606,Cluster 3
2157,7,2,4,3,609.76953,Cluster 3
2158,10,3,5,5,561.5461,Cluster 3
2159,173,29,97,76,105.25609,Cluster 3
2161,4,2,2,2,16.868263,Cluster 3
2162,5,4,4,1,181.11389,Cluster 3
2163,27,5,14,13,115.23882,Cluster 3
2164,88,23,44,44,10.122009,Cluster 3
2165,4,3,3,1,816.01874,Cluster 3
2167,83,25,43,40,82.08053,Cluster 3
2168,61,14,36,25,113.984245,Cluster 3
2170,37,10,19,18,222.48833,Cluster 3
2171,134,15,104,30,96.15962,Cluster 3
2174,27,5,15,12,99.307335,Cluster 3
2176,4,2,2,2,479.46146,Cluster 3
2177,11,5,6,5,101.43793,Cluster 3
2179,21,9,11,10,211.73251,Cluster 3
2181,15,5,9,6,84.26189,Cluster 3
2182,29,9,15,14,202.89964,Cluster 3
2183,36,11,19,17,458.1817,Cluster 3
2184,115,32,60,55,33.299423,Cluster 3
2185,11,3,7,4,616.5888,Cluster 3
2186,34,7,32,2,213.22057,Cluster 3
2187,7,3,5,2,709.55176,Cluster 3
2188,18,9,10,8,176.59108,Cluster 3
2191,113,27,57,56,28.447298,Cluster 3
2192,23,11,12,11,62.296333,Cluster 3
2193,7,3,4,3,222.14706,Cluster 3
2194,11,4,6,5,481.81586,Cluster 3
2195,23,2,12,11,45.01501,Cluster 3
2196,58,12,43,15,239.26677,Cluster 3
2197,11,3,5,6,0.13169974,Cluster 3
2199,5,1,3,2,244.80028,Cluster 3
2200,10,5,5,5,458.7641,Cluster 3
2201,32,8,17,15,155.42049,Cluster 3
2203,10,8,9,1,192.36362,Cluster 3
2204,4,2,2,2,582.0342,Cluster 3
2205,48,7,25,23,119.64159,Cluster 3
2206,20,6,14,6,310.19543,Cluster 3
2207,57,14,31,26,254.6714,Cluster 3
2208,11,5,6,5,308.43488,Cluster 3
2209,132,25,73,59,45.700306,Cluster 3
2210,21,6,13,8,192.33983,Cluster 3
2212,7,2,5,2,304.38074,Cluster 3
2214,41,11,24,17,14.2173395,Cluster 3
2215,17,9,14,3,952.4809,Cluster 3
2216,7,4,6,1,0.5196991,Cluster 3
2217,2,1,1,1,432.00015,Cluster 3
2218,15,6,8,7,39.636097,Cluster 3
2219,72,18,41,31,208.03777,Cluster 3
2221,12,5,6,6,104.274796,Cluster 3
2223,20,7,11,9,7.8282485,Cluster 3
2224,181,12,90,91,46.62396,Cluster 3
2225,24,7,23,1,32.71528,Cluster 3
2226,2,1,1,1,12.0002775,Cluster 3
2227,24,10,12,12,64.83804,Cluster 3
2228,46,9,32,14,5.361395,Cluster 3
2229,6,4,4,2,0.06340278,Cluster 3
2230,56,6,44,12,221.03683,Cluster 3
2231,100,21,58,42,87.32192,Cluster 3
2232,32,10,16,16,122.26697,Cluster 3
2233,7,4,6,1,3.2315278,Cluster 3
2234,8,4,4,4,621.0039,Cluster 3
2235,18,5,17,1,581.1609,Cluster 3
2236,3,2,2,1,575.9997,Cluster 3
2237,38,9,24,14,143.12988,Cluster 3
2239,13,5,7,6,152.68768,Cluster 3
2241,2,1,1,1,528.8175,Cluster 3
2242,146,14,85,61,208.21973,Cluster 3
2243,5,1,3,2,87.21489,Cluster 3
2244,14,5,7,7,273.02695,Cluster 3
2245,73,18,38,35,220.97545,Cluster 3
2247,13,4,7,6,129.12788,Cluster 3
2248,3,1,2,1,8.894259,Cluster 3
2249,20,9,11,9,279.8736,Cluster 3
2251,22,7,11,11,384.75,Cluster 3
2252,105,19,59,46,73.63102,Cluster 3
2253,3,2,2,1,0.5769445,Cluster 3
2254,4,2,2,2,36.09667,Cluster 3
2255,23,5,17,6,419.827,Cluster 3
2256,3,1,2,1,80.0,Cluster 3
2257,14,6,7,7,192.14024,Cluster 3
2259,3,2,2,1,453.455,Cluster 3
2261,2,1,1,1,12.000556,Cluster 3
2262,8,4,4,4,322.0041,Cluster 3
2264,19,4,10,9,154.06372,Cluster 3
2265,23,10,12,11,184.85216,Cluster 3
2266,15,5,8,7,167.59175,Cluster 3
2268,98,23,49,49,69.74116,Cluster 3
2269,4,2,3,1,248.17833,Cluster 3
2271,4,2,2,2,112.79521,Cluster 3
2272,4,1,1,3,83.68986,Cluster 3
2273,52,10,29,23,9.127642,Cluster 3
2274,48,10,36,12,219.925,Cluster 3
2275,108,25,61,47,68.69165,Cluster 3
2277,55,22,32,23,373.21637,Cluster 3
2278,13,6,7,6,132.38855,Cluster 3
2279,9,6,6,3,215.90343,Cluster 3
2280,6,3,3,3,243.67972,Cluster 3
2281,24,9,14,10,423.2304,Cluster 3
2282,30,5,18,12,119.21148,Cluster 3
2284,77,15,39,38,49.10916,Cluster 3
2285,13,3,9,4,92.32562,Cluster 3
2286,9,3,5,4,5.2989535,Cluster 3
2287,33,16,17,16,115.98905,Cluster 3
2288,84,12,49,35,55.53536,Cluster 3
2289,23,7,12,11,108.24758,Cluster 3
2290,43,8,26,17,212.3073,Cluster 3
2291,43,13,30,13,180.47557,Cluster 3
2292,8,3,4,4,6.441343,Cluster 3
2293,12,7,8,4,321.57938,Cluster 3
2294,10,4,6,4,540.5262,Cluster 3
2295,9,5,5,4,231.02281,Cluster 3
2297,17,6,9,8,144.98012,Cluster 3
2298,3,2,2,1,2.1088889,Cluster 3
2299,29,3,15,14,83.26448,Cluster 3
2300,130,35,67,63,38.188152,Cluster 3
2301,24,8,23,1,604.9406,Cluster 3
2303,72,26,38,34,59.69774,Cluster 3
2304,26,7,15,11,181.31923,Cluster 3
2305,20,11,12,8,205.94498,Cluster 3
2306,39,7,32,7,236.99255,Cluster 3
2307,13,5,7,6,140.14384,Cluster 3
2308,46,15,25,21,52.753376,Cluster 3
2309,123,7,61,62,23.729769,Cluster 3
2310,24,6,15,9,139.03911,Cluster 3
2312,11,4,6,5,17.553768,Cluster 3
2313,6,3,4,2,246.8869,Cluster 3
2314,16,6,9,7,160.30885,Cluster 3
2315,126,27,94,32,112.60144,Cluster 3
2316,8,4,5,3,47.04997,Cluster 3
2317,38,12,22,16,97.07634,Cluster 3
2318,58,15,30,28,57.130882,Cluster 3
2319,5,3,3,2,813.43805,Cluster 3
2321,3,2,2,1,1070.7268,Cluster 3
2322,192,10,98,94,46.274155,Cluster 3
2323,21,11,11,10,73.12358,Cluster 3
2324,176,12,90,86,49.637875,Cluster 3
2325,16,4,11,5,69.74523,Cluster 3
2326,19,7,10,9,29.80588,Cluster 3
2327,103,36,63,40,70.826836,Cluster 3
2328,9,5,6,3,0.9340278,Cluster 3
2329,72,6,65,7,98.93442,Cluster 3
2330,74,18,38,36,43.382168,Cluster 3
2331,20,8,12,8,59.14937,Cluster 3
2333,127,17,62,65,57.354294,Cluster 3
2334,182,40,96,86,34.51871,Cluster 3
2336,45,3,18,27,116.4555,Cluster 3
2337,34,11,16,18,85.1547,Cluster 3
2338,35,13,18,17,20.566315,Cluster 3
2339,8,2,4,4,16.5672,Cluster 3
2340,27,10,16,11,330.2361,Cluster 3
2341,2,1,1,1,433.14764,Cluster 3
2342,23,7,12,11,98.57877,Cluster 3
2343,12,6,7,5,0.26378858,Cluster 3
2344,17,7,10,7,191.0535,Cluster 3
2345,3,1,2,1,168.54723,Cluster 3
2346,371,32,190,181,59.37535,Cluster 3
2347,2,1,1,1,0.9593056,Cluster 3
2348,18,11,13,5,1069.2255,Cluster 3
2349,6,2,3,3,210.48843,Cluster 3
2350,3,2,2,1,0.6784722,Cluster 3
2351,109,29,59,50,17.562614,Cluster 3
2352,18,7,10,8,391.42654,Cluster 3
2353,29,9,15,14,16.922394,Cluster 3
2354,15,6,9,6,9.985092,Cluster 3
2355,8,5,5,3,16.10699,Cluster 3
2356,2,1,1,1,1.0815278,Cluster 3
2357,2,1,1,1,407.21695,Cluster 3
2358,31,13,16,15,105.11155,Cluster 3
2359,3,2,2,1,120.41055,Cluster 3
2361,10,5,5,5,221.67903,Cluster 3
2362,8,3,4,4,20.245556,Cluster 3
2363,130,21,66,64,5.1088223,Cluster 3
2364,13,4,8,5,171.91557,Cluster 3
2365,9,4,5,4,155.57082,Cluster 3
2366,28,10,16,12,339.4986,Cluster 3
2367,28,5,17,11,103.533066,Cluster 3
2368,177,22,91,86,16.530348,Cluster 3
2369,109,16,55,54,47.965534,Cluster 3
2370,4,1,2,2,378.07242,Cluster 3
2371,60,23,34,26,35.27719,Cluster 3
2372,13,5,7,6,72.8744,Cluster 3
2373,4,2,2,2,0.3301389,Cluster 3
2374,9,6,6,3,12.057639,Cluster 3
2376,40,10,21,19,65.66335,Cluster 3
2377,51,14,26,25,76.0996,Cluster 3
2378,5,2,3,2,458.63928,Cluster 3
2379,41,15,23,18,101.53069,Cluster 3
2380,51,14,49,2,94.60354,Cluster 3
2381,13,2,11,2,174.92195,Cluster 3
2382,331,8,180,151,21.54007,Cluster 3
2383,23,4,12,11,52.5298,Cluster 3
2384,25,9,15,10,268.96432,Cluster 3
2385,8,3,5,3,397.949,Cluster 3
2386,17,8,8,9,476.02307,Cluster 3
2387,69,12,40,29,92.44229,Cluster 3
2388,9,3,5,4,46.4409,Cluster 3
2389,73,25,43,30,66.91957,Cluster 3
2390,9,5,7,2,159.0226,Cluster 3
2391,12,5,6,6,150.23676,Cluster 3
2392,9,5,5,4,3.0747917,Cluster 3
2394,7,5,5,2,245.90854,Cluster 3
2395,7,3,4,3,466.48477,Cluster 3
2396,34,3,17,17,16.75352,Cluster 3
2397,16,9,12,4,322.46158,Cluster 3
2398,60,10,30,30,7.19132,Cluster 3
2399,39,10,25,14,90.04692,Cluster 3
2400,97,9,57,40,62.845474,Cluster 3
2401,74,14,39,35,129.69202,Cluster 3
2402,37,8,28,9,52.31495,Cluster 3
2403,51,16,25,26,33.477665,Cluster 3
2404,3,2,2,1,0.013472222,Cluster 3
2405,71,22,37,34,22.734545,Cluster 3
2406,16,4,8,8,74.30462,Cluster 3
2407,3,2,2,1,0.5147222,Cluster 3
2408,20,5,18,2,198.00298,Cluster 3
2409,2,1,1,1,0.05263889,Cluster 3
2412,14,6,7,7,59.775314,Cluster 3
2413,3,1,2,1,73.05296,Cluster 3
2414,67,26,37,30,76.69887,Cluster 3
2416,15,7,12,3,171.3052,Cluster 3
2417,6,2,3,3,45.483265,Cluster 3
2418,8,4,4,4,623.4348,Cluster 3
2419,14,4,11,3,298.4364,Cluster 3
2420,13,4,7,6,35.282303,Cluster 3
2421,17,6,9,8,232.47197,Cluster 3
2423,42,14,20,22,87.01888,Cluster 3
2426,216,23,123,93,63.02633,Cluster 3
2427,7,3,4,3,351.89355,Cluster 3
2428,2,1,1,1,0.16722222,Cluster 3
2429,24,7,17,7,129.08165,Cluster 3
2432,6,3,4,2,0.10212963,Cluster 3
2433,22,10,20,2,386.02057,Cluster 3
2434,3,1,2,1,496.44177,Cluster 3
2437,121,14,64,57,19.711714,Cluster 3
2438,5,2,4,1,210.30188,Cluster 3
2439,9,8,8,1,85.839584,Cluster 3
2442,5,4,4,1,1007.97015,Cluster 3
2444,20,5,11,9,100.61825,Cluster 3
2445,26,13,13,13,235.38821,Cluster 3
2446,9,2,6,3,74.42551,Cluster 3
2447,42,6,31,11,16.48784,Cluster 3
2448,6,4,4,2,28.780348,Cluster 3
2449,28,12,15,13,110.951965,Cluster 3
2450,3,1,2,1,0.13175926,Cluster 3
2452,9,3,5,4,51.988956,Cluster 3
2454,16,6,9,7,9.193121,Cluster 3
2455,12,3,9,3,1.4720371,Cluster 3
2456,83,15,42,41,22.58063,Cluster 3
2457,51,16,30,21,8.5946045,Cluster 3
2458,9,5,7,2,37.165382,Cluster 3
2460,3,2,2,1,11.669583,Cluster 3
2461,54,4,29,25,39.02144,Cluster 3
2462,21,7,11,10,85.304436,Cluster 3
2463,4,2,2,2,437.60992,Cluster 3
2464,6,3,3,3,329.071,Cluster 3
2465,12,4,6,6,68.98531,Cluster 3
2466,12,4,6,6,49.655903,Cluster 3
2468,71,21,42,29,40.28269,Cluster 3
2469,23,8,13,10,73.77898,Cluster 3
2470,19,9,11,8,193.17932,Cluster 3
2472,12,5,7,5,113.04645,Cluster 3
2473,7,3,4,3,225.18604,Cluster 3
2474,11,4,7,4,154.35788,Cluster 3
2475,45,18,24,21,47.35226,Cluster 3
2476,5,2,4,1,337.31772,Cluster 3
2477,2,1,1,1,0.14527778,Cluster 3
2478,8,2,5,3,364.97726,Cluster 3
2479,5,1,3,2,187.2,Cluster 3
2480,2,1,1,1,12.0,Cluster 3
2481,5,4,4,1,155.49374,Cluster 3
2482,10,2,5,5,1.6078646,Cluster 3
2483,10,2,6,4,7.7818403,Cluster 3
2484,52,13,25,27,8.056605,Cluster 3
2487,15,5,9,6,85.443275,Cluster 3
2488,16,10,15,1,356.23395,Cluster 3
2489,11,4,7,4,76.283485,Cluster 3
2490,5,3,3,2,275.4223,Cluster 3
2491,10,4,6,4,48.98228,Cluster 3
2492,16,8,9,7,118.74165,Cluster 3
2493,13,4,11,2,26.894115,Cluster 3
2494,2,1,1,1,35.630833,Cluster 3
2496,3,2,2,1,443.99985,Cluster 3
2497,34,16,20,14,163.41348,Cluster 3
2498,12,5,7,5,351.13568,Cluster 3
2499,11,6,6,5,93.54964,Cluster 3
2501,99,24,74,25,61.387783,Cluster 3
2502,6,3,4,2,280.0,Cluster 3
2504,28,12,17,11,119.55074,Cluster 3
2505,3,1,2,1,465.44778,Cluster 3
2507,2,1,1,1,36.000137,Cluster 3
2508,94,22,49,45,49.48387,Cluster 3
2509,7,2,4,3,0.03636111,Cluster 3
2510,14,7,7,7,58.315853,Cluster 3
2512,4,2,3,1,128.13074,Cluster 3
2513,9,5,7,2,9.205625,Cluster 3
2514,4,2,2,2,222.40881,Cluster 3
2516,99,28,48,51,57.598446,Cluster 3
2517,2,1,1,1,204.40388,Cluster 3
2518,18,7,13,5,127.43032,Cluster 3
2519,8,2,5,3,206.12103,Cluster 3
2520,41,17,24,17,44.716797,Cluster 3
2521,147,37,83,64,22.633396,Cluster 3
2523,21,7,11,10,123.26206,Cluster 3
2524,22,8,17,5,149.07957,Cluster 3
2525,11,6,6,5,60.42228,Cluster 3
2526,35,12,22,13,141.27031,Cluster 3
2527,233,34,136,97,19.898113,Cluster 3
2529,13,5,10,3,93.164536,Cluster 3
2530,6,3,3,3,11.38162,Cluster 3
2531,7,4,5,2,150.62613,Cluster 3
2532,10,4,5,5,162.5381,Cluster 3
2533,2,1,1,1,2.3356946,Cluster 3
2534,102,15,58,44,65.68522,Cluster 3
2535,12,7,8,4,321.63586,Cluster 3
2536,12,9,9,3,76.61773,Cluster 3
2537,16,6,10,6,375.88297,Cluster 3
2538,32,19,19,13,139.5029,Cluster 3
2539,2,1,1,1,0.05111111,Cluster 3
2540,94,16,55,39,71.15271,Cluster 3
2541,4,1,2,2,305.89056,Cluster 3
2543,88,26,48,40,56.844254,Cluster 3
2544,30,9,15,15,32.26251,Cluster 3
2545,29,7,21,8,59.022896,Cluster 3
2547,2,1,1,1,0.084305555,Cluster 3
2548,112,29,60,52,33.133827,Cluster 3
2550,13,4,6,7,13.9575,Cluster 3
2552,17,8,12,5,53.482952,Cluster 3
2553,9,7,7,2,324.0539,Cluster 3
2554,7,3,4,3,211.30309,Cluster 3
2556,8,5,5,3,337.3612,Cluster 3
2557,87,30,46,41,29.91322,Cluster 3
2558,12,4,8,4,245.1866,Cluster 3
2559,4,2,2,2,6.2225,Cluster 3
2560,42,15,25,17,37.31522,Cluster 3
2561,11,5,6,5,6.6414165,Cluster 3
2562,23,17,19,4,359.66232,Cluster 3
2563,3,1,2,1,0.22888888,Cluster 3
2564,20,8,11,9,25.408703,Cluster 3
2565,6,3,4,2,256.18967,Cluster 3
2566,9,5,5,4,16.566355,Cluster 3
2567,262,34,145,117,11.724008,Cluster 3
2569,3,1,2,1,24.0,Cluster 3
2570,10,6,8,2,62.867794,Cluster 3
2571,57,17,31,26,20.566465,Cluster 3
2572,14,6,13,1,276.20578,Cluster 3
2575,8,2,5,3,98.95142,Cluster 3
2576,5,2,3,2,60.6575,Cluster 3
2577,66,8,39,27,25.17374,Cluster 3
2578,27,12,14,13,61.4329,Cluster 3
2579,19,10,11,8,19.960989,Cluster 3
2580,37,13,22,15,5.103514,Cluster 3
2581,16,4,9,7,30.727755,Cluster 3
2582,19,11,12,7,27.052856,Cluster 3
2583,11,6,6,5,64.51989,Cluster 3
2585,25,7,14,11,55.470352,Cluster 3
2586,4,1,2,2,0.61493057,Cluster 3
2587,5,2,4,1,0.39962962,Cluster 3
2589,19,6,16,3,224.15768,Cluster 3
2590,6,5,5,1,0.47013888,Cluster 3
2592,21,11,13,8,115.77908,Cluster 3
2593,12,6,7,5,67.99997,Cluster 3
2596,33,11,18,15,104.17709,Cluster 3
2597,5,3,4,1,0.22314815,Cluster 3
2598,4,2,2,2,200.19176,Cluster 3
2599,11,4,7,4,84.44717,Cluster 3
2600,11,3,6,5,61.48919,Cluster 3
2601,17,9,13,4,204.2576,Cluster 3
2603,36,12,18,18,11.704519,Cluster 3
2605,37,9,20,17,2.5582478,Cluster 3
2606,59,15,30,29,8.058022,Cluster 3
2608,19,3,11,8,55.659946,Cluster 3
2609,4,2,3,1,0.128125,Cluster 3
2611,10,4,5,5,92.869965,Cluster 3
2613,9,4,5,4,0.6631944,Cluster 3
2614,7,6,6,1,2.0680556,Cluster 3
2615,6,3,4,2,0.9589583,Cluster 3
2619,11,3,8,3,103.4698,Cluster 3
2620,49,14,27,22,40.33093,Cluster 3
2621,13,8,10,3,51.19426,Cluster 3
2622,4,2,2,2,0.03361111,Cluster 3
2623,2,1,1,1,0.86,Cluster 3
2624,14,5,11,3,46.248413,Cluster 3
2625,2,1,1,1,1.1227778,Cluster 3
2627,29,10,14,15,34.652214,Cluster 3
2628,80,36,44,36,16.73606,Cluster 3
2630,5,3,3,2,1.1148611,Cluster 3
2633,15,8,8,7,79.10482,Cluster 3
2634,16,6,9,7,47.108032,Cluster 3
2636,15,9,14,1,163.15791,Cluster 3
2638,6,3,4,2,0.8864352,Cluster 3
2639,13,4,7,6,42.19507,Cluster 3
2641,9,8,8,1,1.2648611,Cluster 3
2642,4,2,2,2,77.25243,Cluster 3
2643,9,4,7,2,43.296017,Cluster 3
2644,33,10,19,14,71.05491,Cluster 3
2645,5,3,3,2,58.77222,Cluster 3
2646,3,2,2,1,0.62708336,Cluster 3
2647,39,15,25,14,48.776573,Cluster 3
2648,22,3,12,10,38.26684,Cluster 3
2649,11,3,9,2,17.24693,Cluster 3
2651,7,4,5,2,0.63277775,Cluster 3
2652,5,2,3,2,20.017384,Cluster 3
2655,30,10,16,14,24.663067,Cluster 3
2657,13,6,7,6,26.376041,Cluster 3
2660,4,2,2,2,252.0,Cluster 3
2661,8,3,6,2,137.10574,Cluster 3
2664,6,3,4,2,72.14729,Cluster 3
2665,13,5,8,5,4.8775387,Cluster 3
2666,12,6,6,6,42.561993,Cluster 3
2668,6,3,4,2,44.729443,Cluster 3
2669,6,4,4,2,4.8770137,Cluster 3
2670,38,13,30,8,55.73781,Cluster 3
2671,15,4,9,6,5.262992,Cluster 3
2672,8,4,4,4,6.775451,Cluster 3
2673,13,4,7,6,33.126442,Cluster 3
2674,9,4,5,4,2.760023,Cluster 3
2675,9,4,5,4,5.0773845,Cluster 3
2677,17,9,9,8,13.547535,Cluster 3
2678,7,4,4,3,12.605,Cluster 3
2680,12,5,7,5,116.9817,Cluster 3
2683,14,4,7,7,73.76985,Cluster 3
2684,11,5,7,4,54.61302,Cluster 3
2685,55,18,32,23,1.3331857,Cluster 3
2687,13,6,8,5,48.011333,Cluster 3
2690,3,2,2,1,61.62847,Cluster 3
2693,10,3,7,3,32.150875,Cluster 3
2694,19,9,10,9,31.598959,Cluster 3
2695,20,10,17,3,10.696482,Cluster 3
2696,48,14,41,7,11.224264,Cluster 3
2698,9,2,5,4,18.262014,Cluster 3
2700,15,6,9,6,5.475213,Cluster 3
